//MAP CONVERTED BY dmm2tgm.py THIS HEADER COMMENT PREVENTS RECONVERSION, DO NOT REMOVE
"a" = (
/obj/effect/turf_decal/corner/opaque/white{
	dir = 6
	},
/obj/effect/turf_decal/corner/opaque/lime{
	dir = 8
	},
/obj/effect/turf_decal/corner/opaque/pink{
	dir = 1
	},
/obj/effect/decal/cleanable/dirt/dust,
/turf/open/floor/plasteel/dark,
/area/ruin/jungle/paradise/cargo{
	name = "clown and mime hideout"
	})
"b" = (
/obj/structure/dresser,
/obj/effect/turf_decal/corner/opaque/white{
	dir = 10
	},
/turf/open/floor/plasteel/dark,
/area/ruin/jungle/paradise/cargo)
"d" = (
/obj/structure/closet/cabinet,
/obj/item/toy/plush/hornet/gay,
/obj/item/lipstick/random,
/obj/item/lipstick/random,
/obj/item/clothing/mask/gas/clown_hat,
/obj/item/clothing/under/rank/civilian/clown/orange,
/obj/item/clothing/under/rank/civilian/clown/rainbow,
/obj/effect/turf_decal/corner/opaque/solgovgold,
/obj/effect/turf_decal/corner/opaque/lime{
	dir = 8
	},
/obj/effect/turf_decal/corner/opaque/pink{
	dir = 1
	},
/obj/effect/turf_decal/corner/opaque/bottlegreen{
	dir = 4
	},
/obj/item/clothing/under/rank/civilian/clown/orange,
/obj/item/clothing/neck/tie/lesbian,
/obj/item/bikehorn,
/obj/effect/decal/cleanable/confetti,
/turf/open/floor/plasteel/dark,
/area/ruin/jungle/paradise/cargo)
"e" = (
/obj/structure/mirror{
	pixel_x = 23
	},
/obj/structure/table/wood,
/obj/effect/turf_decal/corner/opaque/white{
	dir = 10
	},
/obj/item/lipstick/jade{
	pixel_x = -4;
	pixel_y = 5
	},
/obj/item/chainsaw{
	alpha = 30;
	desc = "A nearly see-through weapon, seems custom made for a mime. It has a slight coating of dried blood from seemingly years ago.";
	hitsound = null
	},
/turf/open/floor/plasteel/dark,
/area/ruin/jungle/paradise/cargo)
"j" = (
/turf/open/floor/carpet/nanoweave/beige,
/area/ruin/jungle/paradise/cargo)
"o" = (
/obj/effect/turf_decal/corner/opaque/solgovgold,
/obj/effect/turf_decal/corner/opaque/lime{
	dir = 8
	},
/obj/effect/turf_decal/corner/opaque/pink{
	dir = 1
	},
/obj/effect/turf_decal/corner/opaque/bottlegreen{
	dir = 4
	},
/obj/effect/decal/cleanable/dirt/dust,
/turf/open/floor/plasteel/dark,
/area/ruin/jungle/paradise/cargo)
"p" = (
/obj/structure/closet/crate/wooden,
/obj/item/melee/sword/claymore{
	pixel_x = -3
	},
/obj/item/melee/sword/claymore{
	pixel_x = 5
	},
/obj/item/clothing/head/peaceflower{
	desc = "An extremely addictive flower, full of lesbian magic."
	},
/obj/effect/turf_decal/corner/opaque/blue,
/obj/effect/turf_decal/corner/opaque/red{
	dir = 8
	},
/obj/effect/turf_decal/corner/opaque/purple{
	dir = 1
	},
/obj/effect/turf_decal/corner/opaque/bottlegreen{
	dir = 4
	},
/obj/effect/decal/cleanable/cobweb,
/turf/open/floor/plasteel/dark,
/area/ruin/jungle/paradise/cargo)
"q" = (
/obj/effect/turf_decal/corner/opaque/solgovgold,
/obj/effect/turf_decal/corner/opaque/lime{
	dir = 8
	},
/obj/effect/turf_decal/corner/opaque/pink{
	dir = 1
	},
/obj/effect/turf_decal/corner/opaque/bottlegreen{
	dir = 4
	},
/obj/effect/decal/cleanable/dirt/dust,
/obj/effect/decal/cleanable/dirt/dust,
/turf/open/floor/plasteel/dark,
/area/ruin/jungle/paradise/cargo)
"r" = (
/obj/effect/turf_decal/corner/opaque/white{
	dir = 10
	},
/turf/open/floor/plasteel/dark,
/area/ruin/jungle/paradise/cargo)
"s" = (
/obj/effect/turf_decal/corner/opaque/solgovgold,
/obj/effect/turf_decal/corner/opaque/lime{
	dir = 8
	},
/obj/effect/turf_decal/corner/opaque/pink{
	dir = 1
	},
/obj/effect/turf_decal/corner/opaque/bottlegreen{
	dir = 4
	},
/obj/structure/table/wood,
/obj/effect/decal/cleanable/confetti,
/obj/item/grown/bananapeel{
	pixel_y = 7;
	pixel_x = 1
	},
/obj/item/storage/crayons,
/turf/open/floor/plasteel/dark,
/area/ruin/jungle/paradise/cargo)
"t" = (
/obj/effect/turf_decal/corner/opaque/white{
	dir = 10
	},
/obj/structure/table/wood,
/obj/item/paper_bin{
	pixel_y = 4;
	pixel_x = 4
	},
/obj/item/pen{
	pixel_x = -8;
	pixel_y = 5
	},
/turf/open/floor/plasteel/dark,
/area/ruin/jungle/paradise/cargo)
"u" = (
/obj/effect/turf_decal/corner/opaque/blue,
/obj/effect/turf_decal/corner/opaque/red{
	dir = 8
	},
/obj/effect/turf_decal/corner/opaque/purple{
	dir = 1
	},
/obj/effect/turf_decal/corner/opaque/bottlegreen{
	dir = 4
	},
/obj/item/chair/wood{
	dir = 8;
	pixel_y = -9;
	pixel_x = 7
	},
/obj/effect/decal/cleanable/generic,
/turf/open/floor/plasteel/dark,
/area/ruin/jungle/paradise/cargo)
"v" = (
/obj/structure/closet/cabinet,
/obj/item/clothing/under/dress/striped,
/obj/item/clothing/under/rank/civilian/mime/skirt,
/obj/effect/turf_decal/corner/opaque/white{
	dir = 10
	},
/obj/item/clothing/mask/gas/mime,
/obj/item/storage/backpack/mime,
/obj/item/clothing/neck/tie/lesbian,
/obj/item/clothing/under/rank/civilian/mime,
/turf/open/floor/plasteel/dark,
/area/ruin/jungle/paradise/cargo)
"w" = (
/obj/effect/turf_decal/corner/opaque/solgovgold,
/obj/effect/turf_decal/corner/opaque/lime{
	dir = 8
	},
/obj/effect/turf_decal/corner/opaque/pink{
	dir = 1
	},
/obj/effect/turf_decal/corner/opaque/bottlegreen{
	dir = 4
	},
/turf/open/floor/plasteel/dark,
/area/ruin/jungle/paradise/cargo)
"y" = (
/obj/effect/turf_decal/corner/opaque/blue,
/obj/effect/turf_decal/corner/opaque/red{
	dir = 8
	},
/obj/effect/turf_decal/corner/opaque/purple{
	dir = 1
	},
/obj/effect/turf_decal/corner/opaque/bottlegreen{
	dir = 4
	},
/obj/effect/decal/cleanable/plastic,
/obj/structure/table/wood,
/obj/item/stack/cable_coil/pink,
/obj/item/assembly/igniter{
	pixel_x = -5;
	pixel_y = 10
	},
/obj/item/reagent_containers/food/drinks/soda_cans/canned_laughter{
	pixel_x = 5;
	pixel_y = 17
	},
/turf/open/floor/plasteel/dark,
/area/ruin/jungle/paradise/cargo)
"z" = (
/obj/structure/bed{
	pixel_y = 14
	},
/obj/item/bedsheet/clown{
	pixel_y = 15
	},
/obj/effect/turf_decal/corner/opaque/white{
	dir = 6
	},
/obj/effect/turf_decal/corner/opaque/red{
	dir = 8
	},
/obj/effect/turf_decal/corner/opaque/purple{
	dir = 1
	},
/turf/open/floor/plasteel/dark,
/area/ruin/jungle/paradise/cargo)
"A" = (
/obj/effect/turf_decal/corner/opaque/solgovgold,
/obj/effect/turf_decal/corner/opaque/lime{
	dir = 8
	},
/obj/effect/turf_decal/corner/opaque/pink{
	dir = 1
	},
/obj/effect/turf_decal/corner/opaque/bottlegreen{
	dir = 4
	},
/obj/item/reagent_containers/food/drinks/soda_cans/canned_laughter{
	pixel_x = -13;
	pixel_y = -6
	},
/obj/item/reagent_containers/food/drinks/soda_cans/canned_laughter{
	pixel_x = -4;
	pixel_y = -6
	},
/obj/item/reagent_containers/food/drinks/soda_cans/canned_laughter{
	pixel_x = 5;
	pixel_y = -6
	},
/obj/item/reagent_containers/food/drinks/soda_cans/canned_laughter{
	pixel_x = 14;
	pixel_y = -6
	},
/obj/effect/decal/cleanable/plastic,
/obj/effect/decal/cleanable/confetti,
/obj/effect/decal/cleanable/dirt/dust,
/turf/open/floor/plasteel/dark,
/area/ruin/jungle/paradise/cargo)
"C" = (
/obj/effect/turf_decal/corner/opaque/white{
	dir = 10
	},
/obj/effect/decal/cleanable/dirt/dust,
/turf/open/floor/plasteel/dark,
/area/ruin/jungle/paradise/cargo)
"D" = (
/turf/open/floor/carpet/orange,
/area/ruin/jungle/paradise/cargo)
"F" = (
/obj/effect/turf_decal/corner/opaque/white{
	dir = 6
	},
/obj/effect/turf_decal/corner/opaque/red{
	dir = 8
	},
/obj/effect/turf_decal/corner/opaque/purple{
	dir = 1
	},
/turf/open/floor/plasteel/dark,
/area/ruin/jungle/paradise/cargo)
"H" = (
/obj/effect/turf_decal/corner/opaque/solgovgold,
/obj/effect/turf_decal/corner/opaque/lime{
	dir = 8
	},
/obj/effect/turf_decal/corner/opaque/pink{
	dir = 1
	},
/obj/effect/turf_decal/corner/opaque/bottlegreen{
	dir = 4
	},
/obj/item/trash/can/food{
	pixel_x = -9;
	pixel_y = -6
	},
/obj/effect/decal/cleanable/confetti,
/obj/item/restraints/handcuffs/cable,
/turf/open/floor/plasteel/dark,
/area/ruin/jungle/paradise/cargo)
"I" = (
/turf/closed/wall/mineral/wood,
/area/ruin/jungle/paradise/cargo)
"K" = (
/obj/structure/mineral_door/wood,
/turf/open/floor/wood,
/area/ruin/jungle/paradise/cargo)
"L" = (
/obj/effect/turf_decal/corner/opaque/white{
	dir = 10
	},
/obj/structure/chair/wood{
	dir = 4
	},
/turf/open/floor/plasteel/dark,
/area/ruin/jungle/paradise/cargo)
"N" = (
/obj/effect/turf_decal/corner/opaque/white{
	dir = 10
	},
/obj/structure/chair/wood{
	dir = 1
	},
/obj/machinery/light/small/broken/directional/east,
/turf/open/floor/plasteel/dark,
/area/ruin/jungle/paradise/cargo)
"R" = (
/obj/machinery/light/small/broken/directional/south,
/turf/open/floor/carpet/purple,
/area/ruin/jungle/paradise/cargo)
"S" = (
/obj/effect/turf_decal/corner/opaque/blue,
/obj/effect/turf_decal/corner/opaque/red{
	dir = 8
	},
/obj/effect/turf_decal/corner/opaque/purple{
	dir = 1
	},
/obj/effect/turf_decal/corner/opaque/bottlegreen{
	dir = 4
	},
/obj/effect/decal/cleanable/dirt/dust,
/turf/open/floor/plasteel/dark,
/area/ruin/jungle/paradise/cargo)
"T" = (
/obj/structure/bed,
/obj/item/bedsheet/mime,
/obj/effect/turf_decal/corner/opaque/white{
	dir = 6
	},
/obj/effect/turf_decal/corner/opaque/lime{
	dir = 8
	},
/obj/effect/turf_decal/corner/opaque/pink{
	dir = 1
	},
/obj/item/toy/plush/knight{
	pixel_y = -1
	},
/obj/machinery/light/small/broken/directional/north,
/turf/open/floor/plasteel/dark,
/area/ruin/jungle/paradise/cargo)
"U" = (
/obj/effect/turf_decal/corner/opaque/white{
	dir = 10
	},
/obj/structure/easel,
/obj/item/canvas/twentythreeXtwentythree{
	pixel_x = 3
	},
/obj/item/canvas/twentythreeXtwentythree{
	pixel_x = 3
	},
/obj/item/canvas/twentythreeXtwentythree{
	pixel_x = 3
	},
/turf/open/floor/plasteel/dark,
/area/ruin/jungle/paradise/cargo)
"X" = (
/obj/effect/turf_decal/corner/opaque/blue,
/obj/effect/turf_decal/corner/opaque/red{
	dir = 8
	},
/obj/effect/turf_decal/corner/opaque/purple{
	dir = 1
	},
/obj/effect/turf_decal/corner/opaque/bottlegreen{
	dir = 4
	},
/obj/item/trash/can/food{
	pixel_y = -1
	},
/obj/item/trash/can/food{
	pixel_x = -6;
	pixel_y = 8
	},
/obj/item/trash/can/food{
	pixel_x = -6
	},
/obj/item/trash/can/food{
	pixel_y = 8;
	pixel_x = 5
	},
/obj/item/trash/can/food{
	pixel_x = 8
	},
/obj/item/trash/can/food{
	pixel_x = -10;
	pixel_y = -7
	},
/obj/item/trash/can/food{
	pixel_y = -1
	},
/obj/item/trash/can/food{
	pixel_y = -9
	},
/obj/item/trash/can/food{
	pixel_y = 10
	},
/obj/item/trash/can/food{
	pixel_y = 10;
	pixel_x = 9
	},
/obj/item/trash/can/food{
	pixel_y = 10;
	pixel_x = 9
	},
/obj/item/trash/can/food{
	pixel_y = 10;
	pixel_x = 9
	},
/obj/item/trash/can/food{
	pixel_x = 6;
	pixel_y = -6
	},
/obj/item/trash/can/food{
	pixel_x = -2;
	pixel_y = 4
	},
/obj/item/trash/can/food{
	pixel_x = 3
	},
/obj/effect/decal/cleanable/generic,
/obj/effect/decal/cleanable/plastic,
/obj/machinery/light/small/broken/directional/west,
/obj/effect/decal/cleanable/dirt/dust,
/turf/open/floor/plasteel/dark,
/area/ruin/jungle/paradise/cargo)
"Y" = (
/obj/effect/turf_decal/corner/opaque/blue,
/obj/effect/turf_decal/corner/opaque/red{
	dir = 8
	},
/obj/effect/turf_decal/corner/opaque/purple{
	dir = 1
	},
/obj/effect/turf_decal/corner/opaque/bottlegreen{
	dir = 4
	},
/obj/item/lipstick/purple{
	pixel_x = -4;
	pixel_y = -10
	},
/obj/item/lipstick/jade{
	pixel_x = 6
	},
/turf/open/floor/plasteel/dark,
/area/ruin/jungle/paradise/cargo)

(1,1,1) = {"
I
I
I
I
I
I
I
"}
(2,1,1) = {"
I
p
d
X
s
y
I
"}
(3,1,1) = {"
I
A
Y
H
u
q
I
"}
(4,1,1) = {"
I
S
w
S
o
D
I
"}
(5,1,1) = {"
I
T
z
a
F
j
K
"}
(6,1,1) = {"
I
r
r
r
C
R
I
"}
(7,1,1) = {"
I
U
r
r
L
r
I
"}
(8,1,1) = {"
I
t
N
v
e
b
I
"}
(9,1,1) = {"
I
I
I
I
I
I
I
"}
