//MAP CONVERTED BY dmm2tgm.py THIS HEADER COMMENT PREVENTS RECONVERSION, DO NOT REMOVE
"b" = (
/obj/machinery/holopad/emergency/command,
/obj/structure/cable{
	icon_state = "1-8"
	},
/turf/open/floor/mineral/plastitanium,
/area/ship/bridge)
"c" = (
/obj/machinery/door/poddoor/shutters/preopen{
	dir = 8;
	id = "felon_doors"
	},
/obj/structure/fans/tiny,
/obj/effect/decal/cleanable/oil/slippery{
	icon_state = "floor5";
	pixel_x = 0;
	pixel_y = 0
	},
/obj/structure/cable{
	icon_state = "4-8"
	},
/obj/docking_port/mobile{
	can_move_docking_ports = 1;
	dir = 4;
	port_direction = 2;
	preferred_direction = 4;
	name = "felon"
	},
/turf/open/floor/mineral/plastitanium,
/area/ship/bridge)
"e" = (
/obj/structure/cable{
	icon_state = "0-4"
	},
/obj/structure/window/plasma/reinforced/spawner/west{
	dir = 1
	},
/obj/structure/window/plasma/reinforced/spawner/east,
/obj/structure/window/plasma/reinforced/spawner,
/obj/machinery/power/shuttle/engine/electric,
/obj/machinery/door/poddoor/shutters/preopen{
	dir = 8;
	id = "felon_thr"
	},
/turf/open/floor/plating,
/area/ship/bridge)
"h" = (
/obj/structure/crate_shelf/built,
/obj/effect/decal/cleanable/plasma,
/obj/structure/cable{
	icon_state = "4-8"
	},
/obj/structure/closet/crate/hydroponics{
	name = "bulk cannabis crate"
	},
/obj/structure/closet/crate/hydroponics{
	name = "bulk ambrosia crate"
	},
/turf/open/floor/mineral/plastitanium,
/area/ship/bridge)
"i" = (
/obj/structure/cable{
	icon_state = "4-8"
	},
/obj/effect/decal/cleanable/dirt/dust,
/obj/machinery/light/floor,
/turf/open/floor/mineral/plastitanium,
/area/ship/bridge)
"k" = (
/obj/effect/decal/cleanable/dirt/dust,
/turf/closed/wall/mineral/plastitanium/nodiagonal,
/area/ship/bridge)
"o" = (
/obj/structure/cable{
	icon_state = "0-4"
	},
/obj/structure/window/plasma/reinforced/spawner/west{
	dir = 2
	},
/obj/structure/window/plasma/reinforced/spawner/east,
/obj/structure/window/plasma/reinforced/spawner/north,
/obj/machinery/power/shuttle/engine/electric,
/obj/machinery/door/poddoor/shutters/preopen{
	dir = 8;
	id = "felon_thr"
	},
/turf/open/floor/plating,
/area/ship/bridge)
"u" = (
/obj/effect/decal/cleanable/dirt/dust,
/obj/structure/cable{
	icon_state = "0-8"
	},
/obj/machinery/light/floor,
/obj/machinery/light_switch{
	dir = 1;
	pixel_x = 11;
	pixel_y = -16
	},
/obj/machinery/power/apc/auto_name/directional/south,
/turf/open/floor/mineral/plastitanium,
/area/ship/bridge)
"w" = (
/obj/structure/cable{
	icon_state = "0-8"
	},
/obj/machinery/power/smes/shuttle/precharged,
/obj/structure/window/plasma/reinforced/spawner/west,
/obj/structure/window/plasma/reinforced/spawner/north,
/obj/machinery/door/poddoor/shutters/preopen{
	dir = 8;
	id = "felon_thr"
	},
/obj/machinery/door/window/brigdoor/eastleft,
/turf/open/floor/mineral/plastitanium,
/area/ship/bridge)
"x" = (
/obj/structure/cable{
	icon_state = "1-2"
	},
/obj/effect/decal/cleanable/plasma,
/obj/structure/cable{
	icon_state = "4-8"
	},
/turf/open/floor/mineral/plastitanium,
/area/ship/bridge)
"y" = (
/obj/machinery/turretid{
	pixel_x = -7;
	pixel_y = -30;
	id = "ntrider"
	},
/obj/structure/chair/comfy/shuttle{
	dir = 8
	},
/turf/open/floor/mineral/plastitanium,
/area/ship/bridge)
"z" = (
/obj/machinery/power/smes/shuttle/precharged,
/obj/structure/cable{
	icon_state = "0-8"
	},
/obj/structure/window/plasma/reinforced/spawner/west,
/obj/machinery/door/window/brigdoor/eastright,
/obj/structure/window/plasma/reinforced/spawner,
/obj/machinery/door/poddoor/shutters/preopen{
	dir = 8;
	id = "felon_thr"
	},
/turf/open/floor/mineral/plastitanium,
/area/ship/bridge)
"F" = (
/obj/effect/decal/cleanable/plastic,
/obj/structure/cable{
	icon_state = "4-8"
	},
/turf/open/floor/mineral/plastitanium,
/area/ship/bridge)
"H" = (
/obj/machinery/power/terminal{
	dir = 8
	},
/obj/effect/decal/cleanable/plasma,
/obj/structure/cable{
	icon_state = "0-2"
	},
/obj/machinery/airalarm/directional/north{
	pixel_x = 0;
	pixel_y = 38
	},
/obj/machinery/light/floor,
/turf/open/floor/mineral/plastitanium,
/area/ship/bridge)
"I" = (
/turf/closed/wall/mineral/plastitanium/nodiagonal,
/area/ship/bridge)
"L" = (
/obj/machinery/computer/helm{
	dir = 8
	},
/obj/item/radio/intercom/directional/north{
	pixel_x = 5;
	pixel_y = 31
	},
/obj/machinery/button/door{
	pixel_x = -9;
	pixel_y = 24;
	name = "window shutters";
	id = "felon_window"
	},
/obj/machinery/button/door{
	pixel_x = -11;
	pixel_y = -22;
	id = "felon_doors";
	dir = 1;
	name = "door shutters"
	},
/obj/effect/decal/cleanable/dirt/dust,
/obj/effect/decal/cleanable/plastic,
/turf/open/floor/mineral/plastitanium,
/area/ship/bridge)
"O" = (
/obj/machinery/power/terminal{
	dir = 8
	},
/obj/structure/cable,
/obj/structure/cable{
	icon_state = "1-4"
	},
/obj/machinery/button/door{
	pixel_x = -7;
	pixel_y = -21;
	id = "felon_doors";
	dir = 1;
	name = "door shutters"
	},
/turf/open/floor/mineral/plastitanium,
/area/ship/bridge)
"Q" = (
/obj/item/radio/intercom/wideband/directional{
	pixel_x = 36;
	pixel_y = -31
	},
/obj/structure/chair/comfy/shuttle{
	dir = 4
	},
/obj/effect/decal/cleanable/dirt/dust,
/turf/open/floor/mineral/plastitanium,
/area/ship/bridge)
"R" = (
/turf/template_noop,
/area/template_noop)
"S" = (
/obj/structure/chair/comfy/shuttle{
	dir = 8
	},
/obj/structure/closet/wall/blue/directional/north{
	icon_state = "emergency_wall"
	},
/obj/item/tank/internals/emergency_oxygen/engi,
/obj/item/tank/internals/emergency_oxygen/engi,
/obj/item/tank/internals/emergency_oxygen/engi,
/obj/item/clothing/mask/breath,
/obj/item/clothing/mask/breath,
/obj/item/clothing/mask/breath,
/turf/open/floor/mineral/plastitanium,
/area/ship/bridge)
"T" = (
/obj/machinery/power/terminal{
	dir = 8
	},
/obj/structure/cable{
	icon_state = "2-4"
	},
/obj/structure/cable{
	icon_state = "0-2"
	},
/obj/machinery/button/door{
	pixel_x = -7;
	pixel_y = 21;
	name = "thrusters shutters";
	id = "felon_thr"
	},
/obj/effect/decal/cleanable/dirt/dust,
/turf/open/floor/mineral/plastitanium,
/area/ship/bridge)
"U" = (
/obj/machinery/power/smes/engineering,
/obj/structure/cable{
	icon_state = "0-8"
	},
/obj/machinery/jukebox/boombox{
	pixel_x = 0;
	pixel_y = 9
	},
/turf/open/floor/mineral/plastitanium,
/area/ship/bridge)
"W" = (
/obj/structure/window/plasma/reinforced/plastitanium,
/obj/structure/grille,
/obj/machinery/door/poddoor/shutters/preopen{
	dir = 8;
	id = "felon_window"
	},
/turf/open/floor/plasteel/lightdark,
/area/ship/bridge)

(1,1,1) = {"
R
e
c
o
R
"}
(2,1,1) = {"
I
z
i
w
I
"}
(3,1,1) = {"
I
T
x
O
I
"}
(4,1,1) = {"
I
U
F
h
I
"}
(5,1,1) = {"
I
H
b
u
k
"}
(6,1,1) = {"
I
S
Q
y
I
"}
(7,1,1) = {"
I
I
L
I
I
"}
(8,1,1) = {"
R
I
W
I
R
"}
