//MAP CONVERTED BY dmm2tgm.py THIS HEADER COMMENT PREVENTS RECONVERSION, DO NOT REMOVE
"a" = (
/obj/machinery/computer/helm/retro{
	dir = 4
	},
/obj/machinery/button/door{
	pixel_x = -2;
	pixel_y = -21;
	id = "pebble_door";
	dir = 1
	},
/obj/machinery/button/shieldwallgen{
	pixel_y = -20;
	pixel_x = 7;
	id = "pebble_holo";
	dir = 1
	},
/obj/machinery/button/door{
	pixel_x = -7;
	pixel_y = -30;
	id = "pebble_window";
	dir = 1;
	name = "windows button"
	},
/obj/effect/turf_decal/corner/opaque/yellow/border{
	dir = 8
	},
/obj/effect/turf_decal/corner/opaque/yellow/border,
/obj/machinery/newscaster/directional/south{
	pixel_x = 17
	},
/turf/open/floor/plasteel/dark,
/area/ship/bridge)
"f" = (
/obj/machinery/power/smes/engineering{
	icon_state = "panel";
	dir = 1;
	density = 0;
	pixel_y = 32
	},
/obj/structure/cable{
	icon_state = "0-4"
	},
/obj/effect/turf_decal/corner/opaque/yellow/border{
	dir = 1
	},
/obj/structure/closet{
	anchored = 1
	},
/obj/item/clothing/head/helmet/space/pilot/random,
/obj/item/clothing/suit/space/pilot,
/obj/item/tank/internals/oxygen,
/obj/item/storage/toolbox/mechanical,
/obj/item/pickaxe,
/turf/open/floor/plasteel/dark,
/area/ship/bridge)
"j" = (
/turf/closed/wall,
/area/ship/bridge)
"k" = (
/obj/machinery/door/poddoor/shutters/preopen{
	dir = 8;
	id = "pebble_door"
	},
/obj/machinery/power/shieldwallgen/atmos{
	id = "pebble_holo";
	anchored = 1
	},
/obj/structure/cable{
	icon_state = "0-8"
	},
/turf/open/floor/plating,
/area/ship/bridge)
"l" = (
/obj/machinery/power/terminal{
	dir = 1
	},
/obj/structure/cable{
	icon_state = "0-8"
	},
/obj/structure/cable{
	icon_state = "2-4"
	},
/obj/structure/cable{
	icon_state = "2-8"
	},
/obj/effect/turf_decal/corner/opaque/yellow/border{
	dir = 1
	},
/obj/structure/chair/comfy/shuttle,
/turf/open/floor/plasteel/dark,
/area/ship/bridge)
"n" = (
/obj/structure/cable{
	icon_state = "0-8"
	},
/obj/machinery/power/shuttle/engine/electric{
	dir = 8
	},
/turf/open/floor/plating,
/area/ship/bridge)
"o" = (
/obj/structure/cable{
	icon_state = "4-8"
	},
/obj/effect/turf_decal/corner/opaque/yellow/border{
	dir = 1
	},
/obj/structure/cable{
	icon_state = "2-8"
	},
/obj/structure/chair/comfy/shuttle,
/turf/open/floor/plasteel/dark,
/area/ship/bridge)
"r" = (
/obj/structure/cable{
	icon_state = "1-2"
	},
/turf/closed/wall,
/area/ship/bridge)
"s" = (
/obj/effect/turf_decal/corner/opaque/yellow/border,
/obj/machinery/power/apc/auto_name/directional/south,
/obj/structure/cable{
	icon_state = "0-1"
	},
/obj/machinery/light_switch{
	pixel_y = -17;
	pixel_x = 11;
	dir = 1
	},
/obj/machinery/holopad,
/turf/open/floor/plasteel/dark,
/area/ship/bridge)
"u" = (
/obj/machinery/power/port_gen/pacman/super{
	anchored = 1
	},
/obj/machinery/power/terminal{
	dir = 4
	},
/obj/structure/cable,
/obj/effect/turf_decal/corner/opaque/yellow/border{
	dir = 8
	},
/obj/effect/turf_decal/corner/opaque/yellow/border{
	dir = 1
	},
/obj/machinery/light/small/directional/north,
/turf/open/floor/plasteel/dark,
/area/ship/bridge)
"v" = (
/obj/machinery/power/smes/shuttle/precharged,
/obj/structure/window/reinforced{
	dir = 8
	},
/obj/structure/window/reinforced{
	dir = 4
	},
/obj/structure/window/reinforced{
	icon_state = "rwindow";
	dir = 1
	},
/obj/structure/cable{
	icon_state = "0-4"
	},
/obj/machinery/door/poddoor/shutters{
	id = "pebble_window";
	dir = 1
	},
/turf/open/floor/plating,
/area/ship/bridge)
"D" = (
/obj/machinery/power/smes/shuttle/precharged{
	dir = 1
	},
/obj/structure/window/reinforced{
	dir = 8
	},
/obj/structure/window/reinforced{
	dir = 4
	},
/obj/structure/window/reinforced,
/obj/structure/cable{
	icon_state = "0-4"
	},
/obj/machinery/door/poddoor/shutters{
	id = "pebble_window"
	},
/turf/open/floor/plating,
/area/ship/bridge)
"F" = (
/turf/closed/wall/yesdiag,
/area/ship/bridge)
"J" = (
/obj/effect/spawner/structure/window/reinforced,
/obj/machinery/door/poddoor/shutters{
	dir = 4;
	id = "pebble_window"
	},
/turf/open/floor/plating,
/area/ship/bridge)
"R" = (
/obj/machinery/power/terminal,
/obj/structure/cable{
	icon_state = "0-1"
	},
/obj/structure/cable{
	icon_state = "1-4"
	},
/obj/effect/turf_decal/corner/opaque/yellow/border,
/obj/machinery/light/floor,
/turf/open/floor/plasteel/dark,
/area/ship/bridge)
"S" = (
/obj/structure/chair/comfy/shuttle{
	dir = 8
	},
/obj/effect/turf_decal/corner/opaque/yellow/border,
/obj/item/radio/intercom/wideband/directional/south,
/turf/open/floor/plasteel/dark,
/area/ship/bridge)
"T" = (
/obj/machinery/door/poddoor/shutters/preopen{
	dir = 8;
	id = "pebble_door"
	},
/obj/machinery/power/shieldwallgen/atmos{
	id = "pebble_holo";
	anchored = 1;
	dir = 1
	},
/obj/structure/cable{
	icon_state = "0-8"
	},
/obj/docking_port/mobile{
	dir = 8;
	preferred_direction = 8;
	port_direction = 2
	},
/turf/open/floor/plating,
/area/ship/bridge)

(1,1,1) = {"
F
J
J
F
"}
(2,1,1) = {"
r
u
a
j
"}
(3,1,1) = {"
j
f
S
j
"}
(4,1,1) = {"
j
o
s
j
"}
(5,1,1) = {"
v
l
R
D
"}
(6,1,1) = {"
n
k
T
n
"}
