//MAP CONVERTED BY dmm2tgm.py THIS HEADER COMMENT PREVENTS RECONVERSION, DO NOT REMOVE
"b" = (
/obj/structure/chair/comfy/shuttle{
	dir = 1;
	pixel_x = 0;
	pixel_y = 5
	},
/obj/effect/turf_decal/siding/red{
	dir = 2;
	color = "#212d60"
	},
/obj/structure/cable{
	icon_state = "0-8"
	},
/obj/effect/turf_decal/trimline/opaque/ntblue,
/obj/machinery/power/apc/auto_name/directional/south,
/turf/open/floor/plasteel/lightdark,
/area/ship/bridge)
"c" = (
/turf/closed/wall/mineral/titanium,
/area/ship/bridge)
"e" = (
/obj/machinery/porta_turret/ship/nt/heavy{
	dir = 9;
	id = "ntrider"
	},
/turf/closed/wall/mineral/titanium,
/area/ship/bridge)
"f" = (
/obj/structure/chair/comfy/shuttle{
	dir = 4;
	pixel_x = 0;
	pixel_y = 6;
	name = "Kovrik"
	},
/obj/structure/closet/secure_closet/wall/directional/north{
	icon_state = "sec_wall";
	pixel_x = 0;
	pixel_y = 33
	},
/obj/effect/turf_decal/siding/red{
	dir = 1;
	color = "#212d60";
	layer = 2.9
	},
/obj/item/storage/box/handcuffs,
/obj/item/storage/box/bodybags,
/obj/machinery/button/door{
	id = "Torpeda_windows";
	name = "window shutters";
	pixel_x = 24;
	pixel_y = 24
	},
/obj/effect/turf_decal/trimline/opaque/ntblue,
/obj/item/reagent_containers/hypospray/medipen,
/obj/item/reagent_containers/hypospray/medipen,
/obj/item/reagent_containers/hypospray/medipen,
/turf/open/floor/plasteel/lightdark,
/area/ship/bridge)
"h" = (
/turf/closed/wall/mineral/titanium/nodiagonal,
/area/ship/bridge)
"i" = (
/obj/structure/sign/nanotrasen{
	pixel_x = 3;
	pixel_y = -5
	},
/turf/closed/wall/mineral/titanium,
/area/ship/bridge)
"k" = (
/obj/machinery/door/poddoor/shutters/preopen{
	id = "Doorss"
	},
/obj/docking_port/mobile{
	can_move_docking_ports = 1;
	dir = 4;
	port_direction = 2;
	preferred_direction = 4;
	name = "jet lancer"
	},
/obj/structure/fans/tiny,
/obj/effect/turf_decal/siding/red{
	dir = 8;
	color = "#212d60"
	},
/obj/effect/turf_decal/siding/red{
	dir = 4;
	color = "#212d60"
	},
/obj/structure/cable{
	icon_state = "1-2"
	},
/turf/open/floor/plasteel/lightdark,
/area/ship/bridge)
"n" = (
/obj/effect/turf_decal/siding/red{
	dir = 8;
	color = "#212d60"
	},
/obj/effect/turf_decal/siding/red{
	dir = 4;
	color = "#212d60"
	},
/obj/machinery/light/floor,
/obj/structure/cable{
	icon_state = "1-2"
	},
/turf/open/floor/plasteel/lightdark,
/area/ship/bridge)
"o" = (
/obj/structure/cable{
	icon_state = "0-4"
	},
/obj/machinery/power/shuttle/engine/electric,
/turf/open/floor/plasteel/dark,
/area/ship/bridge)
"r" = (
/obj/effect/decal/cleanable/dirt/dust,
/turf/closed/wall/mineral/titanium/nodiagonal,
/area/ship/bridge)
"t" = (
/obj/machinery/power/terminal{
	dir = 8
	},
/obj/structure/cable{
	icon_state = "0-2"
	},
/obj/effect/turf_decal/siding/red{
	dir = 5;
	color = "#212d60"
	},
/obj/machinery/button/door{
	pixel_x = -5;
	pixel_y = 21;
	id = "Torpedo_thr";
	dir = 2;
	name = "Thrusters doors"
	},
/turf/open/floor/plasteel/lightdark,
/area/ship/bridge)
"u" = (
/obj/machinery/porta_turret/ship/nt/heavy{
	dir = 5;
	id = "ntrider"
	},
/turf/closed/wall/mineral/titanium,
/area/ship/bridge)
"w" = (
/obj/machinery/power/smes/shuttle/precharged,
/obj/effect/turf_decal/siding/red{
	dir = 10;
	color = "#212d60"
	},
/obj/machinery/door/poddoor/shutters{
	id = "Torpedo_thr";
	dir = 4
	},
/obj/structure/window/reinforced/spawner/west,
/obj/structure/cable{
	icon_state = "0-8"
	},
/obj/effect/turf_decal/siding/red{
	dir = 10;
	color = "#212d60"
	},
/turf/open/floor/plasteel/lightdark,
/area/ship/bridge)
"x" = (
/obj/structure/cable{
	icon_state = "1-2"
	},
/obj/structure/cable{
	icon_state = "1-8"
	},
/obj/structure/cable{
	icon_state = "1-4"
	},
/obj/machinery/light/floor,
/obj/effect/turf_decal/siding/red{
	dir = 2;
	color = "#212d60";
	icon_state = "siding_thinplating_corner"
	},
/turf/open/floor/plasteel/lightdark,
/area/ship/bridge)
"y" = (
/obj/effect/turf_decal/siding/red{
	dir = 4;
	color = "#212d60";
	icon_state = "siding_thinplating_corner"
	},
/obj/effect/turf_decal/siding/red{
	dir = 1;
	color = "#212d60";
	icon_state = "siding_thinplating_corner"
	},
/obj/machinery/holopad/emergency/command{
	pixel_x = 1;
	pixel_y = -12
	},
/obj/structure/cable{
	icon_state = "1-8"
	},
/turf/open/floor/plasteel/lightdark,
/area/ship/bridge)
"z" = (
/obj/structure/cable{
	icon_state = "1-4"
	},
/obj/effect/turf_decal/siding/red{
	dir = 8;
	color = "#212d60"
	},
/obj/structure/closet/emcloset/wall/directional/west,
/obj/effect/turf_decal/trimline/opaque/ntblue,
/obj/item/tank/internals/emergency_oxygen/double,
/obj/item/tank/internals/emergency_oxygen/double,
/obj/item/tank/internals/emergency_oxygen/double,
/obj/item/clothing/mask/breath,
/obj/item/clothing/mask/breath,
/obj/item/clothing/mask/breath,
/turf/open/floor/plasteel/lightdark,
/area/ship/bridge)
"A" = (
/obj/effect/turf_decal/siding/red{
	dir = 1;
	color = "#212d60"
	},
/obj/effect/turf_decal/trimline/opaque/ntblue,
/obj/structure/chair/comfy/shuttle{
	dir = 2;
	pixel_x = 0;
	pixel_y = 7
	},
/obj/structure/cable{
	icon_state = "4-8"
	},
/turf/open/floor/plasteel/lightdark,
/area/ship/bridge)
"B" = (
/obj/machinery/porta_turret/ship/nt/heavy{
	dir = 10;
	id = "ntrider"
	},
/turf/closed/wall/mineral/titanium,
/area/ship/bridge)
"C" = (
/obj/effect/turf_decal/siding/red{
	dir = 6;
	color = "#212d60";
	layer = 2.9
	},
/obj/machinery/computer/crew{
	dir = 8
	},
/turf/open/floor/plasteel/lightdark,
/area/ship/bridge)
"E" = (
/obj/effect/spawner/structure/window/shuttle,
/obj/machinery/door/poddoor/shutters/preopen{
	id = "Torpeda_windows";
	dir = 4
	},
/turf/open/floor/plating,
/area/ship/bridge)
"F" = (
/obj/structure/cable{
	icon_state = "4-8"
	},
/obj/effect/turf_decal/siding/red{
	dir = 2;
	color = "#212d60"
	},
/obj/structure/chair/comfy/shuttle{
	dir = 1;
	pixel_x = 0;
	pixel_y = 5
	},
/obj/effect/turf_decal/trimline/opaque/ntblue,
/turf/open/floor/plasteel/lightdark,
/area/ship/bridge)
"H" = (
/obj/structure/chair/comfy/shuttle{
	dir = 2;
	pixel_x = 0;
	pixel_y = 7
	},
/obj/effect/turf_decal/siding/red{
	dir = 1;
	color = "#212d60"
	},
/obj/machinery/airalarm/directional/north{
	pixel_x = 0;
	pixel_y = 38
	},
/obj/effect/turf_decal/trimline/opaque/ntblue,
/obj/structure/cable{
	icon_state = "4-8"
	},
/turf/open/floor/plasteel/lightdark,
/area/ship/bridge)
"I" = (
/obj/structure/sign/nanotrasen{
	pixel_x = 4;
	pixel_y = 4
	},
/turf/closed/wall/mineral/titanium,
/area/ship/bridge)
"J" = (
/obj/effect/turf_decal/siding/red{
	dir = 8;
	color = "#212d60"
	},
/obj/effect/turf_decal/siding/red{
	dir = 4;
	color = "#212d60"
	},
/obj/machinery/light/floor,
/turf/open/floor/plasteel/lightdark,
/area/ship/bridge)
"L" = (
/obj/effect/turf_decal/siding/red{
	dir = 2;
	color = "#212d60";
	icon_state = "siding_thinplating_corner"
	},
/obj/effect/turf_decal/siding/red{
	dir = 8;
	color = "#212d60";
	icon_state = "siding_thinplating_corner"
	},
/turf/open/floor/plasteel/lightdark,
/area/ship/bridge)
"M" = (
/obj/machinery/computer/helm{
	dir = 8
	},
/obj/effect/turf_decal/siding/red{
	dir = 5;
	color = "#212d60";
	layer = 2.9
	},
/turf/open/floor/plasteel/lightdark,
/area/ship/bridge)
"N" = (
/obj/machinery/power/smes/shuttle/precharged,
/obj/effect/turf_decal/siding/red{
	dir = 1;
	color = "#212d60"
	},
/obj/effect/turf_decal/siding/red{
	dir = 8;
	color = "#212d60"
	},
/obj/machinery/door/poddoor/shutters{
	id = "Torpedo_thr";
	dir = 4
	},
/obj/structure/window/reinforced/spawner/west,
/obj/structure/cable{
	icon_state = "0-8"
	},
/turf/open/floor/plasteel/lightdark,
/area/ship/bridge)
"O" = (
/obj/machinery/power/terminal{
	dir = 8
	},
/obj/structure/cable,
/obj/effect/turf_decal/siding/red{
	dir = 6;
	color = "#212d60"
	},
/obj/machinery/button/door{
	pixel_x = -7;
	pixel_y = -21;
	id = "Torpedo_thr";
	dir = 1;
	name = "Thrusters doors"
	},
/turf/open/floor/plasteel/lightdark,
/area/ship/bridge)
"P" = (
/obj/machinery/porta_turret/ship/nt/heavy{
	dir = 6;
	id = "ntrider"
	},
/turf/closed/wall/mineral/titanium,
/area/ship/bridge)
"Q" = (
/obj/effect/turf_decal/siding/red{
	dir = 2;
	color = "#212d60"
	},
/obj/machinery/turretid{
	pixel_x = -7;
	pixel_y = -30;
	id = "ntrider"
	},
/obj/effect/turf_decal/trimline/opaque/ntblue,
/obj/structure/chair/comfy/shuttle{
	dir = 1;
	pixel_x = 0;
	pixel_y = 5
	},
/turf/open/floor/plasteel/lightdark,
/area/ship/bridge)
"R" = (
/turf/template_noop,
/area/template_noop)
"S" = (
/obj/structure/chair/comfy/shuttle{
	dir = 2;
	pixel_x = 1;
	pixel_y = 6
	},
/obj/effect/turf_decal/siding/red{
	dir = 1;
	color = "#212d60"
	},
/obj/effect/turf_decal/trimline/opaque/ntblue,
/obj/structure/cable{
	icon_state = "4-8"
	},
/turf/open/floor/plasteel/lightdark,
/area/ship/bridge)
"T" = (
/obj/structure/cable{
	icon_state = "1-2"
	},
/obj/machinery/power/terminal{
	dir = 8
	},
/obj/effect/turf_decal/siding/red{
	dir = 4;
	color = "#212d60";
	icon_state = "siding_thinplating_corner"
	},
/obj/machinery/light/floor,
/obj/structure/cable{
	icon_state = "0-4"
	},
/turf/open/floor/plasteel/lightdark,
/area/ship/bridge)
"U" = (
/obj/machinery/door/poddoor/shutters/preopen{
	id = "Doorss"
	},
/obj/structure/fans/tiny,
/obj/effect/turf_decal/siding/red{
	dir = 8;
	color = "#212d60"
	},
/obj/effect/turf_decal/siding/red{
	dir = 4;
	color = "#212d60"
	},
/turf/open/floor/plasteel/lightdark,
/area/ship/bridge)
"V" = (
/obj/structure/cable{
	icon_state = "0-2"
	},
/obj/effect/turf_decal/siding/red{
	dir = 8;
	color = "#212d60"
	},
/obj/machinery/power/smes/engineering{
	charge = 4e+006
	},
/turf/open/floor/plasteel/lightdark,
/area/ship/bridge)
"W" = (
/obj/structure/chair/comfy/shuttle{
	dir = 4;
	pixel_x = 0;
	pixel_y = 7
	},
/obj/effect/turf_decal/siding/red{
	dir = 2;
	color = "#212d60";
	layer = 2.9
	},
/obj/item/radio/intercom/wideband/directional{
	pixel_x = 31;
	pixel_y = -31
	},
/obj/machinery/button/door{
	id = "Doorss";
	name = "airlock shutters";
	pixel_x = -2;
	pixel_y = -24;
	dir = 1
	},
/obj/machinery/light_switch{
	pixel_y = -23;
	pixel_x = 8;
	dir = 1
	},
/obj/effect/turf_decal/trimline/opaque/ntblue,
/turf/open/floor/plasteel/lightdark,
/area/ship/bridge)

(1,1,1) = {"
c
o
c
c
o
c
"}
(2,1,1) = {"
e
N
V
z
w
B
"}
(3,1,1) = {"
c
t
T
x
O
c
"}
(4,1,1) = {"
c
h
A
F
h
c
"}
(5,1,1) = {"
R
h
H
b
h
R
"}
(6,1,1) = {"
i
h
S
Q
h
I
"}
(7,1,1) = {"
k
n
y
L
J
U
"}
(8,1,1) = {"
u
h
f
W
h
P
"}
(9,1,1) = {"
R
c
M
C
r
R
"}
(10,1,1) = {"
R
E
E
E
E
R
"}
