//MAP CONVERTED BY dmm2tgm.py THIS HEADER COMMENT PREVENTS RECONVERSION, DO NOT REMOVE
"a" = (
/turf/closed/wall/mineral/titanium,
/area/ship/bridge)
"i" = (
/obj/machinery/button/door{
	pixel_y = 23;
	id = "sgf_bridge";
	name = "external shutters control";
	pixel_x = 6
	},
/obj/item/paper_bin,
/obj/item/pen/solgov,
/obj/item/folder/solgov{
	pixel_x = 11;
	pixel_y = 7
	},
/obj/structure/table/wood/fancy/blue,
/obj/machinery/newscaster/directional/north{
	pixel_x = -8;
	pixel_y = 30
	},
/turf/open/floor/wood,
/area/ship/bridge)
"k" = (
/obj/effect/turf_decal/industrial/warning{
	dir = 1
	},
/obj/structure/cable/yellow{
	icon_state = "1-2"
	},
/turf/open/floor/plasteel/patterned/cargo_one,
/area/ship/bridge)
"l" = (
/obj/structure/chair/comfy/orange/directional/east,
/obj/effect/turf_decal/techfloor{
	dir = 8
	},
/obj/machinery/light/small/directional/south,
/turf/open/floor/wood,
/area/ship/bridge)
"o" = (
/obj/machinery/power/smes/engineering{
	charge = 5e+006
	},
/obj/structure/window/reinforced/spawner/north,
/obj/structure/window/reinforced/spawner,
/obj/structure/window/reinforced/spawner/west,
/obj/structure/cable{
	icon_state = "0-5"
	},
/obj/structure/cable{
	icon_state = "0-6"
	},
/turf/open/floor/plating,
/area/ship/bridge)
"p" = (
/obj/structure/sign/solgov_seal{
	pixel_y = 0
	},
/turf/closed/wall/mineral/titanium/nodiagonal,
/area/ship/bridge)
"q" = (
/obj/machinery/power/terminal{
	dir = 8
	},
/obj/structure/cable/yellow{
	icon_state = "0-4"
	},
/turf/open/floor/plasteel/patterned/cargo_one,
/area/ship/bridge)
"r" = (
/obj/effect/turf_decal/box/corners{
	icon_state = "box_corners";
	dir = 8
	},
/obj/effect/turf_decal/box/corners,
/obj/machinery/light/small/directional/south,
/obj/structure/crate_shelf,
/turf/open/floor/plasteel/mono,
/area/ship/bridge)
"w" = (
/obj/structure/fans/tiny,
/obj/effect/turf_decal/industrial/warning/fulltile,
/obj/machinery/door/airlock/public{
	icon = 'icons/obj/doors/airlocks/station/solgov.dmi'
	},
/obj/docking_port/mobile{
	can_move_docking_ports = 1;
	preferred_direction = 4;
	port_direction = 4
	},
/turf/open/floor/plasteel/mono/dark,
/area/ship/bridge)
"y" = (
/obj/effect/turf_decal/industrial/warning,
/turf/open/floor/plasteel/patterned/cargo_one,
/area/ship/bridge)
"z" = (
/obj/machinery/power/shuttle/engine/electric{
	dir = 4
	},
/obj/effect/turf_decal/industrial/warning{
	dir = 8
	},
/obj/structure/cable{
	icon_state = "0-4"
	},
/obj/machinery/light/floor,
/turf/open/floor/engine/hull,
/area/ship/bridge)
"B" = (
/obj/effect/turf_decal/industrial/stand_clear{
	dir = 4
	},
/obj/structure/cable/yellow{
	icon_state = "4-8"
	},
/turf/open/floor/plasteel/mono,
/area/ship/bridge)
"C" = (
/obj/structure/window/reinforced/fulltile/shuttle,
/obj/machinery/door/poddoor/shutters{
	dir = 4;
	id = "sgf_bridge"
	},
/turf/open/floor/plating,
/area/ship/bridge)
"D" = (
/turf/closed/wall/mineral/titanium/nodiagonal,
/area/ship/bridge)
"F" = (
/obj/machinery/power/smes/shuttle/precharged{
	dir = 4
	},
/obj/effect/turf_decal/techfloor/orange{
	dir = 8
	},
/obj/structure/window/reinforced{
	dir = 8
	},
/obj/structure/cable{
	icon_state = "0-8"
	},
/obj/machinery/door/poddoor{
	id = "sgf_engine";
	dir = 4
	},
/obj/machinery/door/window/westright{
	dir = 4
	},
/turf/open/floor/plasteel/tech/grid,
/area/ship/bridge)
"I" = (
/obj/machinery/holopad/emergency/command,
/obj/structure/cable/yellow{
	icon_state = "1-8"
	},
/turf/open/floor/plasteel/patterned/cargo_one,
/area/ship/bridge)
"J" = (
/obj/structure/chair/comfy/orange/directional/east,
/obj/effect/turf_decal/techfloor{
	dir = 8
	},
/obj/machinery/light/small/directional/north,
/turf/open/floor/wood,
/area/ship/bridge)
"K" = (
/obj/machinery/computer/cargo/solgov{
	dir = 8
	},
/obj/item/radio/intercom/wideband/directional/south,
/turf/open/floor/wood,
/area/ship/bridge)
"N" = (
/obj/effect/turf_decal/box/corners{
	dir = 1
	},
/obj/effect/turf_decal/box/corners{
	dir = 4
	},
/obj/machinery/light/small/directional/north,
/obj/structure/crate_shelf,
/turf/open/floor/plasteel/mono,
/area/ship/bridge)
"P" = (
/obj/structure/chair/comfy/orange/directional/east,
/obj/effect/turf_decal/techfloor{
	dir = 8
	},
/turf/open/floor/wood,
/area/ship/bridge)
"Q" = (
/obj/machinery/power/smes/shuttle/precharged{
	dir = 4
	},
/obj/effect/turf_decal/techfloor/orange{
	dir = 8
	},
/obj/structure/window/reinforced{
	dir = 8
	},
/obj/structure/cable{
	icon_state = "0-8"
	},
/obj/machinery/door/window/westright{
	dir = 4
	},
/obj/machinery/door/poddoor{
	id = "sgf_engine";
	dir = 4
	},
/turf/open/floor/plasteel/tech/grid,
/area/ship/bridge)
"R" = (
/obj/structure/sign/solgov_seal{
	pixel_y = 0
	},
/turf/closed/wall/mineral/titanium,
/area/ship/bridge)
"T" = (
/obj/machinery/power/terminal{
	dir = 8
	},
/obj/structure/cable{
	icon_state = "0-10"
	},
/obj/machinery/power/apc/auto_name/directional/north,
/obj/machinery/light_switch{
	pixel_x = 11;
	pixel_y = 23
	},
/turf/open/floor/plasteel/patterned/cargo_one,
/area/ship/bridge)
"X" = (
/obj/machinery/power/terminal{
	dir = 8
	},
/obj/structure/cable{
	icon_state = "0-9"
	},
/obj/machinery/button/door{
	pixel_y = -23;
	pixel_x = -9;
	id = "sgf_engine";
	name = "engine blast door control";
	dir = 1
	},
/turf/open/floor/plasteel/patterned/cargo_one,
/area/ship/bridge)
"Y" = (
/obj/structure/fans/tiny,
/obj/effect/turf_decal/industrial/warning/fulltile,
/obj/machinery/door/airlock/public{
	icon = 'icons/obj/doors/airlocks/station/solgov.dmi'
	},
/obj/structure/cable/yellow{
	icon_state = "1-2"
	},
/turf/open/floor/plasteel/mono/dark,
/area/ship/bridge)
"Z" = (
/obj/machinery/computer/helm/solgov{
	dir = 8
	},
/obj/item/desk_flag/solgov{
	pixel_y = -19;
	pixel_x = 9
	},
/turf/open/floor/wood,
/area/ship/bridge)

(1,1,1) = {"
D
z
p
z
D
"}
(2,1,1) = {"
a
Q
o
F
a
"}
(3,1,1) = {"
a
T
q
X
a
"}
(4,1,1) = {"
a
N
B
r
a
"}
(5,1,1) = {"
Y
k
I
y
w
"}
(6,1,1) = {"
a
J
P
l
a
"}
(7,1,1) = {"
a
i
Z
K
a
"}
(8,1,1) = {"
R
C
C
C
R
"}
