//MAP CONVERTED BY dmm2tgm.py THIS HEADER COMMENT PREVENTS RECONVERSION, DO NOT REMOVE
"b" = (
/obj/structure/cable{
	icon_state = "1-2"
	},
/obj/structure/crate_shelf/built,
/turf/open/floor/plasteel/lightdark,
/area/ship/bridge)
"c" = (
/turf/closed/wall/mineral/titanium,
/area/ship/bridge)
"d" = (
/obj/machinery/door/poddoor/shutters/preopen{
	id = "vespa_windows";
	dir = 4
	},
/obj/structure/grille,
/obj/structure/window/reinforced/fulltile/shuttle,
/obj/structure/cable,
/turf/open/floor/plating,
/area/ship/bridge)
"e" = (
/obj/machinery/power/terminal{
	dir = 8
	},
/obj/structure/cable,
/obj/effect/turf_decal/trimline/opaque/solgovblue/filled/corner{
	dir = 1
	},
/obj/effect/turf_decal/trimline/opaque/solgovblue/filled/corner{
	dir = 8
	},
/turf/open/floor/plasteel/lightdark,
/area/ship/bridge)
"f" = (
/obj/machinery/computer/crew{
	dir = 8
	},
/obj/effect/turf_decal/trimline/opaque/solgovblue/filled/line{
	dir = 4
	},
/turf/open/floor/plasteel/lightdark,
/area/ship/bridge)
"g" = (
/obj/machinery/porta_turret/ship/solfed/heavy{
	dir = 5
	},
/turf/closed/wall/mineral/titanium,
/area/ship/bridge)
"h" = (
/turf/closed/wall/mineral/titanium/nodiagonal,
/area/ship/bridge)
"i" = (
/obj/machinery/power/shuttle/engine/electric,
/obj/structure/cable{
	icon_state = "0-4"
	},
/turf/open/floor/plating,
/area/ship/bridge)
"j" = (
/obj/structure/window/reinforced/spawner,
/obj/machinery/power/smes/engineering{
	charge = 4e+006
	},
/obj/structure/cable{
	icon_state = "0-4"
	},
/obj/structure/cable{
	icon_state = "0-6"
	},
/obj/effect/turf_decal/trimline/opaque/solgovblue/filled/end{
	dir = 8
	},
/turf/open/floor/plasteel/lightdark,
/area/ship/bridge)
"k" = (
/obj/machinery/button/door{
	id = "vespa_windows";
	name = "window shutters";
	pixel_x = 24;
	pixel_y = 24
	},
/obj/effect/turf_decal/trimline/opaque/solgovblue/filled/corner{
	dir = 4
	},
/turf/open/floor/plasteel/lightdark,
/area/ship/bridge)
"l" = (
/obj/machinery/door/poddoor/shutters/preopen{
	id = "vespa_windows";
	dir = 4
	},
/obj/structure/grille,
/obj/structure/window/reinforced/fulltile/shuttle,
/obj/structure/cable{
	icon_state = "1-2"
	},
/obj/structure/cable{
	icon_state = "0-2"
	},
/turf/open/floor/plating,
/area/ship/bridge)
"m" = (
/obj/machinery/airalarm/directional/north{
	pixel_x = 0;
	pixel_y = 38
	},
/obj/machinery/light/floor,
/obj/effect/turf_decal/trimline/opaque/solgovblue/filled/line{
	dir = 1
	},
/obj/structure/chair/comfy/shuttle,
/turf/open/floor/plasteel/lightdark,
/area/ship/bridge)
"n" = (
/obj/machinery/porta_turret/ship/solfed/heavy{
	dir = 9
	},
/turf/closed/wall/mineral/titanium,
/area/ship/bridge)
"o" = (
/obj/structure/cable{
	icon_state = "1-8"
	},
/obj/effect/turf_decal/trimline/opaque/solgovblue/filled/corner{
	dir = 8
	},
/turf/open/floor/plasteel/lightdark,
/area/ship/bridge)
"q" = (
/obj/structure/cable{
	icon_state = "4-8"
	},
/obj/structure/cable{
	icon_state = "2-8"
	},
/turf/open/floor/plasteel/lightdark,
/area/ship/bridge)
"r" = (
/obj/effect/decal/cleanable/dirt/dust,
/turf/closed/wall/mineral/titanium/nodiagonal,
/area/ship/bridge)
"s" = (
/obj/machinery/door/poddoor/shutters/preopen{
	id = "vespa_windows";
	dir = 4
	},
/obj/structure/grille,
/obj/structure/window/reinforced/fulltile/shuttle,
/obj/structure/cable{
	icon_state = "0-2"
	},
/turf/open/floor/plating,
/area/ship/bridge)
"t" = (
/obj/machinery/power/terminal{
	dir = 8
	},
/obj/machinery/door/window/brigdoor/security/cell/westright,
/obj/structure/cable{
	icon_state = "2-9"
	},
/obj/structure/cable{
	icon_state = "0-2"
	},
/obj/effect/turf_decal/trimline/opaque/solgovblue/filled/line{
	dir = 8
	},
/turf/open/floor/plasteel/lightdark,
/area/ship/bridge)
"u" = (
/obj/structure/cable{
	icon_state = "1-2"
	},
/turf/open/floor/plasteel/lightdark,
/area/ship/bridge)
"v" = (
/obj/structure/cable{
	icon_state = "4-8"
	},
/obj/effect/turf_decal/trimline/opaque/solgovblue/filled/corner{
	dir = 1
	},
/turf/open/floor/plasteel/lightdark,
/area/ship/bridge)
"w" = (
/obj/machinery/porta_turret/ship/solfed/heavy{
	dir = 10
	},
/turf/closed/wall/mineral/titanium,
/area/ship/bridge)
"x" = (
/obj/structure/cable{
	icon_state = "1-2"
	},
/obj/effect/turf_decal/trimline/opaque/solgovblue/filled/corner{
	dir = 8
	},
/obj/effect/turf_decal/trimline/opaque/solgovblue/filled/corner{
	dir = 1
	},
/turf/open/floor/plasteel/lightdark,
/area/ship/bridge)
"y" = (
/obj/structure/chair/comfy/shuttle{
	dir = 4;
	name = "helm shuttle chair"
	},
/turf/open/floor/plasteel/lightdark,
/area/ship/bridge)
"z" = (
/obj/machinery/light/floor,
/obj/machinery/power/apc/auto_name/directional/south{
	req_ship_access = 0
	},
/obj/structure/cable{
	icon_state = "0-8"
	},
/obj/structure/cable,
/obj/effect/turf_decal/trimline/opaque/solgovblue/filled/line,
/obj/structure/chair/comfy/shuttle{
	dir = 1
	},
/turf/open/floor/plasteel/lightdark,
/area/ship/bridge)
"A" = (
/obj/machinery/computer/helm{
	dir = 8
	},
/obj/effect/turf_decal/trimline/opaque/solgovblue/filled/line{
	dir = 4
	},
/turf/open/floor/plasteel/lightdark,
/area/ship/bridge)
"B" = (
/obj/structure/cable{
	icon_state = "1-2"
	},
/obj/structure/cable{
	icon_state = "2-4"
	},
/obj/effect/turf_decal/trimline/opaque/solgovblue/filled/corner,
/turf/open/floor/plasteel/lightdark,
/area/ship/bridge)
"C" = (
/obj/structure/sign/solfed,
/turf/closed/wall/mineral/titanium,
/area/ship/bridge)
"D" = (
/obj/structure/ore_box,
/turf/open/floor/plasteel/lightdark,
/area/ship/bridge)
"E" = (
/obj/machinery/door/poddoor/shutters/preopen{
	id = "vespa_windows";
	dir = 4
	},
/obj/structure/grille,
/obj/structure/window/reinforced/fulltile/shuttle,
/obj/structure/cable{
	icon_state = "0-8"
	},
/obj/structure/cable{
	icon_state = "2-8"
	},
/obj/structure/cable{
	icon_state = "1-8"
	},
/turf/open/floor/plating,
/area/ship/bridge)
"F" = (
/obj/structure/cable{
	icon_state = "2-4"
	},
/turf/open/floor/plasteel/lightdark,
/area/ship/bridge)
"G" = (
/obj/structure/cable{
	icon_state = "1-8"
	},
/obj/structure/cable{
	icon_state = "1-2"
	},
/obj/effect/turf_decal/trimline/opaque/solgovblue/filled/corner{
	dir = 4
	},
/turf/open/floor/plasteel/lightdark,
/area/ship/bridge)
"H" = (
/obj/machinery/holopad/emergency/command{
	pixel_x = 1;
	pixel_y = -15
	},
/turf/open/floor/plasteel/lightdark,
/area/ship/bridge)
"I" = (
/turf/open/floor/plasteel/lightdark,
/area/ship/bridge)
"J" = (
/obj/machinery/button/door{
	id = "vespadoors";
	name = "airlock shutters";
	pixel_x = -2;
	pixel_y = -24;
	dir = 1
	},
/obj/machinery/light_switch{
	pixel_y = -23;
	pixel_x = 8;
	dir = 1
	},
/obj/structure/table/reinforced/titaniumglass,
/obj/machinery/recharger{
	pixel_x = -6;
	pixel_y = 0
	},
/obj/machinery/recharger{
	pixel_x = 6;
	pixel_y = 0
	},
/obj/effect/turf_decal/trimline/opaque/solgovblue/filled/line{
	dir = 6
	},
/turf/open/floor/plasteel/lightdark,
/area/ship/bridge)
"K" = (
/obj/machinery/telecomms/relay{
	network = "SolNet";
	autolinkers = list("SolHub")
	},
/obj/effect/turf_decal/trimline/opaque/solgovblue/filled/line{
	dir = 5
	},
/obj/machinery/light/floor,
/turf/open/floor/plasteel/lightdark,
/area/ship/bridge)
"L" = (
/obj/item/radio/intercom/wideband/directional{
	pixel_x = 31;
	pixel_y = -31
	},
/obj/structure/cable{
	icon_state = "4-8"
	},
/obj/effect/turf_decal/trimline/opaque/solgovblue/filled/corner,
/turf/open/floor/plasteel/lightdark,
/area/ship/bridge)
"M" = (
/obj/machinery/door/poddoor/shutters/preopen{
	id = "vespadoors"
	},
/obj/structure/fans/tiny,
/obj/structure/cable{
	icon_state = "1-2"
	},
/obj/effect/turf_decal/trimline/opaque/solgovblue/filled/line{
	dir = 4
	},
/turf/open/floor/plasteel/lightdark,
/area/ship/bridge)
"N" = (
/obj/machinery/button/door{
	pixel_x = 5;
	pixel_y = 21;
	id = "vespa_thr";
	dir = 2;
	name = "thrusters shutters"
	},
/obj/structure/cable{
	icon_state = "2-4"
	},
/obj/effect/turf_decal/trimline/opaque/solgovblue/filled/line{
	dir = 9
	},
/obj/machinery/light/floor,
/obj/structure/chair/comfy/shuttle,
/turf/open/floor/plasteel/lightdark,
/area/ship/bridge)
"O" = (
/obj/machinery/button/door{
	pixel_x = -7;
	pixel_y = -21;
	id = "Torpedo_thr";
	dir = 1;
	name = "Thrusters doors"
	},
/obj/structure/cable{
	icon_state = "1-4"
	},
/obj/machinery/turretid{
	pixel_x = -7;
	pixel_y = -30;
	id = "ntrider"
	},
/obj/effect/turf_decal/trimline/opaque/solgovblue/filled/line{
	dir = 10
	},
/obj/machinery/light/floor,
/obj/structure/chair/comfy/shuttle{
	dir = 1
	},
/turf/open/floor/plasteel/lightdark,
/area/ship/bridge)
"P" = (
/obj/structure/table/reinforced/titaniumglass,
/obj/effect/turf_decal/trimline/opaque/solgovblue/filled/line{
	dir = 5
	},
/obj/item/paper_bin,
/obj/item/folder/solgov{
	pixel_x = 0;
	pixel_y = 0
	},
/obj/item/pen/solgov,
/turf/open/floor/plasteel/lightdark,
/area/ship/bridge)
"Q" = (
/obj/machinery/door/poddoor/shutters/preopen{
	id = "vespadoors"
	},
/obj/structure/fans/tiny,
/obj/structure/cable{
	icon_state = "1-2"
	},
/obj/effect/turf_decal/trimline/opaque/solgovblue/filled/line{
	dir = 4
	},
/obj/docking_port/mobile{
	dir = 2;
	port_direction = 8;
	preferred_direction = 4
	},
/turf/open/floor/plasteel/lightdark,
/area/ship/bridge)
"R" = (
/turf/template_noop,
/area/template_noop)
"S" = (
/obj/machinery/mineral/ore_redemption,
/turf/open/floor/plasteel/lightdark,
/area/ship/bridge)
"T" = (
/obj/machinery/power/terminal{
	dir = 8
	},
/obj/machinery/door/window/brigdoor/security/cell/westleft,
/obj/structure/cable,
/obj/structure/cable{
	icon_state = "1-2"
	},
/obj/effect/turf_decal/trimline/opaque/solgovblue/filled/line{
	dir = 8
	},
/turf/open/floor/plasteel/lightdark,
/area/ship/bridge)
"U" = (
/obj/machinery/door/poddoor/shutters/preopen{
	id = "vespadoors"
	},
/obj/structure/fans/tiny,
/obj/effect/turf_decal/trimline/opaque/solgovblue/filled/line{
	dir = 8
	},
/turf/open/floor/plasteel/lightdark,
/area/ship/bridge)
"V" = (
/obj/machinery/power/smes/shuttle/precharged,
/obj/machinery/door/poddoor/shutters{
	id = "vespa_thr";
	dir = 4
	},
/obj/structure/window/reinforced/spawner/west,
/obj/structure/cable{
	icon_state = "0-8"
	},
/turf/open/floor/plating,
/area/ship/bridge)
"W" = (
/obj/structure/cable{
	icon_state = "4-8"
	},
/obj/item/banner/solfed/mundane{
	anchored = 1
	},
/obj/effect/turf_decal/trimline/opaque/solgovblue/filled/line{
	dir = 6
	},
/obj/machinery/light/floor,
/turf/open/floor/plasteel/lightdark,
/area/ship/bridge)
"X" = (
/obj/machinery/porta_turret/ship/solfed/heavy{
	dir = 6
	},
/turf/closed/wall/mineral/titanium,
/area/ship/bridge)
"Y" = (
/obj/structure/window/reinforced/spawner/north,
/obj/structure/closet/emcloset/wall/directional/west,
/obj/item/tank/internals/emergency_oxygen/double,
/obj/item/tank/internals/emergency_oxygen/double,
/obj/item/tank/internals/emergency_oxygen/double,
/obj/item/clothing/mask/breath,
/obj/item/clothing/mask/breath,
/obj/item/clothing/mask/breath,
/obj/item/storage/belt/utility/full/engi,
/obj/effect/turf_decal/trimline/opaque/solgovblue/filled/end{
	dir = 8
	},
/turf/open/floor/plasteel/lightdark,
/area/ship/bridge)
"Z" = (
/obj/structure/cable{
	icon_state = "4-8"
	},
/obj/structure/cable{
	icon_state = "1-2"
	},
/turf/open/floor/plasteel/lightdark,
/area/ship/bridge)

(1,1,1) = {"
R
C
c
i
i
c
C
R
"}
(2,1,1) = {"
n
h
j
V
V
Y
h
w
"}
(3,1,1) = {"
c
N
e
t
T
x
O
c
"}
(4,1,1) = {"
U
v
I
D
S
F
o
U
"}
(5,1,1) = {"
Q
G
u
b
b
Z
B
M
"}
(6,1,1) = {"
c
m
I
H
I
q
z
c
"}
(7,1,1) = {"
c
P
k
y
y
L
J
c
"}
(8,1,1) = {"
g
h
K
A
f
W
r
X
"}
(9,1,1) = {"
R
s
l
l
l
E
d
R
"}
