//MAP CONVERTED BY dmm2tgm.py THIS HEADER COMMENT PREVENTS RECONVERSION, DO NOT REMOVE
"bF" = (
/obj/structure/alien/egg/burst,
/obj/structure/alien/weeds/node,
/turf/open/floor/plating/abductor,
/area/ruin/wasteplanet)
"bR" = (
/obj/structure/table_frame/abductor,
/turf/open/floor/plating/asteroid/wasteplanet,
/area/ruin/wasteplanet)
"cq" = (
/obj/structure/table/abductor,
/obj/machinery/computer/camera_advanced/abductor,
/turf/open/floor/plating/abductor,
/area/ruin/wasteplanet)
"dB" = (
/turf/closed/mineral/random/wasteplanet,
/area/template_noop)
"ew" = (
/obj/machinery/abductor/experiment,
/turf/open/floor/plating/abductor,
/area/ruin/wasteplanet)
"fu" = (
/obj/item/stack/sheet/mineral/abductor,
/turf/open/floor/plating/abductor,
/area/ruin/wasteplanet)
"hJ" = (
/obj/item/bodypart/leg/left/abductor,
/obj/item/radio/headset/abductor,
/turf/open/floor/plating/abductor,
/area/ruin/wasteplanet)
"hX" = (
/obj/structure/alien/egg/burst,
/turf/open/floor/plating/abductor,
/area/ruin/wasteplanet)
"iX" = (
/obj/item/bodypart/chest/abductor,
/turf/open/floor/plating/asteroid/wasteplanet,
/area/template_noop)
"jA" = (
/obj/item/bodypart/head/abductor,
/obj/structure/holosign/barrier/cyborg/hacked/infinite,
/turf/open/floor/plating/wasteplanet/rust,
/area/template_noop)
"ko" = (
/obj/structure/alien/resin/wall,
/turf/open/floor/plating/asteroid/wasteplanet,
/area/ruin/wasteplanet)
"kH" = (
/obj/effect/anomaly/melter/planetary,
/turf/open/floor/plating/wasteplanet/rust,
/area/template_noop)
"kU" = (
/mob/living/simple_animal/hostile/alien/sentinel,
/turf/open/floor/plating/abductor,
/area/ruin/wasteplanet)
"lN" = (
/obj/machinery/abductor/console,
/turf/open/floor/plating/abductor,
/area/ruin/wasteplanet)
"lS" = (
/obj/structure/door_assembly/door_assembly_abductor,
/obj/structure/alien/resin/wall,
/turf/open/floor/plating/asteroid/wasteplanet,
/area/ruin/wasteplanet)
"lV" = (
/obj/structure/alien/resin/wall,
/turf/open/floor/plating/asteroid/wasteplanet,
/area/template_noop)
"mX" = (
/obj/structure/holosign/barrier/cyborg/hacked/infinite,
/turf/open/water/tar/waste,
/area/template_noop)
"nS" = (
/turf/template_noop,
/area/template_noop)
"qD" = (
/obj/structure/closet/abductor,
/obj/item/organ/eyes/night_vision/alien,
/obj/item/organ/body_egg/alien_embryo,
/turf/open/floor/plating/abductor,
/area/ruin/wasteplanet)
"rm" = (
/obj/machinery/abductor/gland_dispenser,
/turf/open/floor/plating/abductor,
/area/ruin/wasteplanet)
"sx" = (
/obj/item/bodypart/leg/left/abductor,
/turf/open/floor/plating/abductor,
/area/ruin/wasteplanet)
"sJ" = (
/turf/open/floor/plating/abductor,
/area/ruin/wasteplanet)
"uA" = (
/obj/effect/gibspawner/xeno,
/turf/open/floor/plating/abductor,
/area/ruin/wasteplanet)
"vq" = (
/mob/living/simple_animal/hostile/alien/drone,
/turf/open/floor/plating/abductor,
/area/ruin/wasteplanet)
"wd" = (
/obj/structure/showcase/horrific_experiment,
/turf/open/floor/plating/abductor,
/area/ruin/wasteplanet)
"Aa" = (
/obj/structure/bed/abductor,
/obj/effect/mob_spawn/human/bartender,
/turf/open/floor/plating/abductor,
/area/ruin/wasteplanet)
"AS" = (
/turf/open/floor/plating/asteroid/wasteplanet,
/area/ruin/wasteplanet)
"CK" = (
/obj/item/bodypart/chest/abductor,
/turf/open/floor/plating/abductor,
/area/ruin/wasteplanet)
"CQ" = (
/obj/item/mine/proximity/explosive/sting/live,
/turf/open/floor/plating/asteroid/wasteplanet,
/area/template_noop)
"Ec" = (
/obj/item/mine/proximity/explosive/live,
/turf/open/floor/plating/wasteplanet/rust,
/area/template_noop)
"Ed" = (
/obj/item/mine/proximity/explosive/live,
/turf/open/floor/plating/dirt/jungle/wasteland,
/area/template_noop)
"EU" = (
/obj/structure/bed/nest,
/turf/open/floor/plating/abductor,
/area/ruin/wasteplanet)
"Fx" = (
/obj/effect/radiation/waste,
/obj/structure/radioactive/waste,
/turf/open/water/waste,
/area/template_noop)
"FY" = (
/turf/open/water/waste,
/area/template_noop)
"Gu" = (
/obj/item/clothing/head/helmet/abductor,
/turf/open/floor/plating/abductor,
/area/ruin/wasteplanet)
"GV" = (
/obj/effect/anomaly/phantom/planetary,
/turf/open/floor/plating/asteroid/wasteplanet,
/area/template_noop)
"HC" = (
/obj/structure/holosign/barrier/cyborg/hacked/infinite,
/turf/open/floor/plating/asteroid/wasteplanet,
/area/template_noop)
"II" = (
/obj/item/mine/proximity/explosive/live,
/turf/open/floor/plating/asteroid/wasteplanet,
/area/template_noop)
"Kd" = (
/obj/item/bodypart/head/abductor,
/turf/open/floor/plating/abductor,
/area/ruin/wasteplanet)
"LK" = (
/obj/item/clothing/suit/armor/abductor/vest,
/turf/open/floor/plating/abductor,
/area/ruin/wasteplanet)
"Nt" = (
/obj/effect/anomaly/grav/high/big/planetary,
/turf/open/floor/plating/asteroid/wasteplanet,
/area/template_noop)
"Oa" = (
/turf/open/floor/plating/wasteplanet/rust,
/area/template_noop)
"Or" = (
/turf/open/water/tar/waste,
/area/template_noop)
"Ou" = (
/obj/structure/holosign/barrier/cyborg/hacked/infinite,
/turf/open/floor/plating/wasteplanet/rust,
/area/template_noop)
"OE" = (
/mob/living/simple_animal/hostile/alien/queen/large,
/turf/open/floor/plating/abductor,
/area/ruin/wasteplanet)
"OJ" = (
/obj/effect/anomaly/pulsar/planetary,
/turf/open/floor/plating/wasteplanet/rust,
/area/template_noop)
"Ro" = (
/obj/structure/door_assembly/door_assembly_abductor,
/turf/open/floor/plating/asteroid/wasteplanet,
/area/ruin/wasteplanet)
"Rq" = (
/obj/machinery/abductor/pad,
/turf/open/floor/plating/abductor,
/area/ruin/wasteplanet)
"SI" = (
/obj/structure/showcase{
	icon = 'icons/obj/abductor.dmi';
	icon_state = "core";
	desc = "An alien power source that produces energy seemingly out of nowhere. Look's like this one didn't work.";
	name = "Void Core"
	},
/obj/effect/anomaly/flux/big/planetary,
/turf/open/floor/plating/abductor,
/area/ruin/wasteplanet)
"ST" = (
/obj/structure/alien/weeds/node,
/turf/open/floor/plating/abductor,
/area/ruin/wasteplanet)
"Tn" = (
/obj/effect/anomaly/heartbeat/planetary,
/turf/open/floor/plating/asteroid/wasteplanet,
/area/template_noop)
"TC" = (
/turf/closed/indestructible/alien,
/area/ruin/wasteplanet)
"VY" = (
/obj/structure/closet/abductor,
/obj/item/crowbar/abductor,
/obj/item/wrench/abductor,
/obj/item/restraints/handcuffs/alien,
/obj/item/restraints/handcuffs/alien,
/obj/item/disk/design_disk/limbs/abductor,
/obj/item/screwdriver/abductor,
/turf/open/floor/plating/abductor,
/area/ruin/wasteplanet)
"WP" = (
/obj/effect/gibspawner/human,
/turf/open/floor/plating/abductor,
/area/ruin/wasteplanet)
"WY" = (
/obj/structure/bed/abductor,
/obj/effect/mob_spawn/human/miner,
/turf/open/floor/plating/abductor,
/area/ruin/wasteplanet)
"Xy" = (
/obj/effect/gibspawner/larva,
/turf/open/floor/plating/abductor,
/area/ruin/wasteplanet)
"XS" = (
/turf/open/floor/plating/asteroid/wasteplanet,
/area/template_noop)
"Zh" = (
/obj/item/mine/proximity/explosive/live,
/turf/open/water/tar/waste,
/area/template_noop)
"ZK" = (
/turf/open/floor/plating/dirt/jungle/wasteland,
/area/template_noop)

(1,1,1) = {"
nS
nS
nS
XS
XS
Nt
Or
Or
Or
FY
Or
Or
XS
XS
XS
nS
nS
nS
nS
nS
"}
(2,1,1) = {"
nS
nS
ZK
Ed
ZK
XS
XS
Or
FY
Fx
FY
mX
XS
II
XS
XS
XS
nS
nS
nS
"}
(3,1,1) = {"
nS
FY
ZK
ZK
dB
dB
dB
dB
dB
dB
dB
dB
HC
XS
XS
iX
XS
XS
nS
nS
"}
(4,1,1) = {"
FY
Fx
FY
dB
dB
dB
dB
dB
dB
dB
dB
dB
dB
HC
Ou
OJ
Oa
XS
nS
nS
"}
(5,1,1) = {"
Or
FY
dB
dB
dB
TC
TC
TC
TC
lS
ko
dB
dB
lV
dB
jA
Ec
Oa
XS
nS
"}
(6,1,1) = {"
Or
Or
dB
dB
TC
TC
hX
hX
bF
bR
ko
ko
ko
lV
dB
Ou
Or
Or
XS
XS
"}
(7,1,1) = {"
XS
dB
dB
TC
TC
wd
Kd
sJ
hJ
sJ
bR
ko
ko
dB
dB
dB
FY
Or
XS
XS
"}
(8,1,1) = {"
XS
dB
dB
TC
rm
sJ
vq
fu
WY
kU
AS
bR
ko
ko
dB
dB
FY
FY
XS
XS
"}
(9,1,1) = {"
XS
dB
dB
TC
cq
sJ
ST
WP
sJ
CK
Xy
fu
Ro
ko
dB
dB
Fx
FY
XS
XS
"}
(10,1,1) = {"
XS
dB
dB
TC
Rq
sJ
LK
sJ
sJ
Gu
sx
ST
SI
TC
dB
dB
FY
FY
XS
XS
"}
(11,1,1) = {"
Tn
dB
dB
TC
lN
sJ
sJ
vq
sJ
sJ
LK
uA
sJ
TC
dB
dB
FY
XS
XS
XS
"}
(12,1,1) = {"
XS
dB
dB
TC
ew
sJ
sJ
uA
Aa
fu
kU
sJ
sJ
TC
dB
dB
XS
XS
XS
XS
"}
(13,1,1) = {"
XS
dB
dB
TC
TC
wd
sJ
OE
sJ
ST
Kd
sJ
TC
TC
dB
dB
XS
XS
XS
XS
"}
(14,1,1) = {"
Zh
dB
dB
dB
TC
TC
VY
EU
EU
sJ
qD
TC
TC
dB
dB
dB
XS
Oa
XS
XS
"}
(15,1,1) = {"
FY
FY
dB
dB
dB
TC
TC
TC
TC
TC
TC
TC
dB
dB
dB
dB
Oa
Oa
Oa
XS
"}
(16,1,1) = {"
FY
Fx
FY
dB
dB
dB
dB
dB
dB
dB
dB
dB
dB
dB
dB
Oa
kH
Oa
Oa
XS
"}
(17,1,1) = {"
Oa
FY
FY
Oa
dB
dB
dB
dB
dB
dB
dB
dB
dB
XS
Oa
Oa
Oa
Ec
Oa
nS
"}
(18,1,1) = {"
nS
Oa
Oa
Oa
Oa
Oa
XS
XS
CQ
FY
Fx
FY
Or
XS
XS
Oa
Oa
Oa
nS
nS
"}
(19,1,1) = {"
nS
nS
Oa
Oa
Oa
XS
XS
GV
XS
FY
FY
Or
XS
XS
XS
Oa
Oa
Oa
nS
nS
"}
(20,1,1) = {"
nS
nS
nS
nS
XS
XS
XS
XS
XS
XS
FY
Or
XS
XS
XS
XS
nS
nS
nS
nS
"}
