//MAP CONVERTED BY dmm2tgm.py THIS HEADER COMMENT PREVENTS RECONVERSION, DO NOT REMOVE
"bF" = (
/obj/structure/alien/egg/burst,
/obj/structure/alien/weeds/node,
/turf/open/floor/plating/abductor,
/area/ruin/wasteplanet)
"bR" = (
/obj/structure/table_frame/abductor,
/turf/open/floor/plating/asteroid/wasteplanet,
/area/ruin/wasteplanet)
"cq" = (
/obj/structure/table/abductor,
/obj/machinery/computer/camera_advanced/abductor,
/turf/open/floor/plating/abductor,
/area/ruin/wasteplanet)
"dB" = (
/turf/closed/mineral/gibtonite,
/area/template_noop)
"ew" = (
/obj/machinery/abductor/experiment,
/turf/open/floor/plating/abductor,
/area/ruin/wasteplanet)
"fu" = (
/obj/item/stack/sheet/mineral/abductor,
/turf/open/floor/plating/abductor,
/area/ruin/wasteplanet)
"hJ" = (
/obj/item/bodypart/leg/left/abductor,
/obj/item/radio/headset/abductor,
/turf/open/floor/plating/abductor,
/area/ruin/wasteplanet)
"hX" = (
/obj/structure/alien/egg/burst,
/turf/open/floor/plating/abductor,
/area/ruin/wasteplanet)
"iX" = (
/obj/item/bodypart/chest/abductor,
/turf/open/floor/plating/asteroid/wasteplanet,
/area/template_noop)
"jA" = (
/obj/item/bodypart/head/abductor,
/obj/structure/holosign/barrier/cyborg/hacked/infinite,
/turf/open/floor/plating/asteroid/basalt/wasteland,
/area/template_noop)
"ko" = (
/obj/structure/alien/resin/wall,
/turf/open/floor/plating/asteroid/wasteplanet,
/area/ruin/wasteplanet)
"kH" = (
/obj/effect/anomaly/melter/planetary,
/turf/open/floor/plating/wasteplanet/rust,
/area/template_noop)
"kU" = (
/mob/living/simple_animal/hostile/alien/sentinel,
/turf/open/floor/plating/abductor,
/area/ruin/wasteplanet)
"lN" = (
/obj/machinery/abductor/console,
/turf/open/floor/plating/abductor,
/area/ruin/wasteplanet)
"lS" = (
/obj/structure/door_assembly/door_assembly_abductor,
/obj/structure/alien/resin/wall,
/turf/open/floor/plating/asteroid/wasteplanet,
/area/ruin/wasteplanet)
"lV" = (
/obj/structure/alien/resin/wall,
/turf/open/floor/plating/asteroid/wasteplanet,
/area/template_noop)
"mX" = (
/obj/structure/holosign/barrier/cyborg/hacked/infinite,
/turf/open/water/tar/waste,
/area/template_noop)
"nQ" = (
/obj/item/mine/proximity/explosive/live,
/turf/open/floor/plating/asteroid/basalt/wasteland,
/area/template_noop)
"nS" = (
/turf/closed/mineral/uranium,
/area/template_noop)
"qD" = (
/obj/structure/closet/abductor,
/obj/item/organ/eyes/night_vision/alien,
/obj/item/organ/body_egg/alien_embryo,
/turf/open/floor/plating/abductor,
/area/ruin/wasteplanet)
"rm" = (
/obj/machinery/abductor/gland_dispenser,
/turf/open/floor/plating/abductor,
/area/ruin/wasteplanet)
"sx" = (
/obj/item/bodypart/leg/left/abductor,
/turf/open/floor/plating/abductor,
/area/ruin/wasteplanet)
"sJ" = (
/turf/open/floor/plating/abductor,
/area/ruin/wasteplanet)
"uA" = (
/obj/effect/gibspawner/xeno,
/turf/open/floor/plating/abductor,
/area/ruin/wasteplanet)
"vq" = (
/mob/living/simple_animal/hostile/alien/drone,
/turf/open/floor/plating/abductor,
/area/ruin/wasteplanet)
"wd" = (
/obj/structure/showcase/horrific_experiment,
/turf/open/floor/plating/abductor,
/area/ruin/wasteplanet)
"xt" = (
/turf/open/floor/plating/asteroid/basalt/wasteland,
/area/template_noop)
"Aa" = (
/obj/structure/bed/abductor,
/obj/effect/mob_spawn/human/bartender,
/turf/open/floor/plating/abductor,
/area/ruin/wasteplanet)
"AS" = (
/turf/open/floor/plating/asteroid/wasteplanet,
/area/ruin/wasteplanet)
"CK" = (
/obj/item/bodypart/chest/abductor,
/turf/open/floor/plating/abductor,
/area/ruin/wasteplanet)
"CQ" = (
/obj/item/mine/proximity/explosive/sting/live,
/turf/open/floor/plating/asteroid/wasteplanet,
/area/template_noop)
"Ec" = (
/turf/closed/mineral/random,
/area/template_noop)
"Ed" = (
/obj/item/mine/proximity/explosive/live,
/turf/open/floor/plating/dirt/jungle/wasteland,
/area/template_noop)
"EU" = (
/obj/structure/bed/nest,
/turf/open/floor/plating/abductor,
/area/ruin/wasteplanet)
"Fx" = (
/obj/effect/radiation/waste,
/obj/structure/radioactive/waste,
/turf/open/water/waste,
/area/template_noop)
"FY" = (
/turf/open/water/waste,
/area/template_noop)
"Gu" = (
/obj/item/clothing/head/helmet/abductor,
/turf/open/floor/plating/abductor,
/area/ruin/wasteplanet)
"GV" = (
/obj/effect/anomaly/phantom/planetary,
/turf/open/floor/plating/asteroid/wasteplanet,
/area/template_noop)
"HC" = (
/obj/structure/holosign/barrier/cyborg/hacked/infinite,
/turf/open/floor/plating/asteroid/wasteplanet,
/area/template_noop)
"II" = (
/obj/item/mine/proximity/explosive/live,
/turf/open/floor/plating/asteroid/wasteplanet,
/area/template_noop)
"Kd" = (
/obj/item/bodypart/head/abductor,
/turf/open/floor/plating/abductor,
/area/ruin/wasteplanet)
"LK" = (
/obj/item/clothing/suit/armor/abductor/vest,
/turf/open/floor/plating/abductor,
/area/ruin/wasteplanet)
"Nt" = (
/obj/effect/anomaly/grav/high/big/planetary,
/turf/open/floor/plating/asteroid/wasteplanet,
/area/template_noop)
"Oa" = (
/turf/open/floor/plating/wasteplanet/rust,
/area/template_noop)
"Or" = (
/turf/open/water/tar/waste,
/area/template_noop)
"Ou" = (
/obj/structure/holosign/barrier/cyborg/hacked/infinite,
/turf/open/floor/plating/asteroid/basalt/wasteland,
/area/template_noop)
"OE" = (
/mob/living/simple_animal/hostile/alien/queen/large,
/turf/open/floor/plating/abductor,
/area/ruin/wasteplanet)
"OJ" = (
/obj/effect/anomaly/pulsar/planetary,
/turf/open/floor/plating/asteroid/basalt/wasteland,
/area/template_noop)
"Ro" = (
/obj/structure/door_assembly/door_assembly_abductor,
/turf/open/floor/plating/asteroid/wasteplanet,
/area/ruin/wasteplanet)
"Rq" = (
/obj/machinery/abductor/pad,
/turf/open/floor/plating/abductor,
/area/ruin/wasteplanet)
"SI" = (
/obj/structure/showcase{
	icon = 'icons/obj/abductor.dmi';
	icon_state = "core";
	desc = "An alien power source that produces energy seemingly out of nowhere. Look's like this one didn't work.";
	name = "Void Core"
	},
/obj/effect/anomaly/flux/big/planetary,
/turf/open/floor/plating/abductor,
/area/ruin/wasteplanet)
"ST" = (
/obj/structure/alien/weeds/node,
/turf/open/floor/plating/abductor,
/area/ruin/wasteplanet)
"Tn" = (
/obj/effect/anomaly/heartbeat/planetary,
/turf/open/floor/plating/asteroid/wasteplanet,
/area/template_noop)
"TC" = (
/turf/closed/indestructible/alien,
/area/ruin/wasteplanet)
"VY" = (
/obj/structure/closet/abductor,
/obj/item/crowbar/abductor,
/obj/item/wrench/abductor,
/obj/item/restraints/handcuffs/alien,
/obj/item/restraints/handcuffs/alien,
/obj/item/disk/design_disk/limbs/abductor,
/obj/item/screwdriver/abductor,
/turf/open/floor/plating/abductor,
/area/ruin/wasteplanet)
"WP" = (
/obj/effect/gibspawner/human,
/turf/open/floor/plating/abductor,
/area/ruin/wasteplanet)
"WY" = (
/obj/structure/bed/abductor,
/obj/effect/mob_spawn/human/miner,
/turf/open/floor/plating/abductor,
/area/ruin/wasteplanet)
"Xy" = (
/obj/effect/gibspawner/larva,
/turf/open/floor/plating/abductor,
/area/ruin/wasteplanet)
"XS" = (
/turf/open/floor/plating/asteroid/wasteplanet,
/area/template_noop)
"Zh" = (
/obj/item/mine/proximity/explosive/live,
/turf/open/water/tar/waste,
/area/template_noop)
"ZK" = (
/turf/open/floor/plating/dirt/jungle/wasteland,
/area/template_noop)

(1,1,1) = {"
ZK
ZK
ZK
XS
XS
Nt
Or
Or
Or
FY
Or
Or
XS
XS
XS
XS
XS
XS
XS
XS
"}
(2,1,1) = {"
ZK
ZK
ZK
Ed
ZK
XS
XS
Or
FY
Fx
FY
mX
XS
II
XS
XS
XS
XS
XS
XS
"}
(3,1,1) = {"
FY
FY
ZK
ZK
Ec
Ec
Ec
Ec
Ec
nS
Ec
Ec
HC
XS
XS
iX
XS
XS
XS
XS
"}
(4,1,1) = {"
FY
Fx
FY
Ec
Ec
Ec
Ec
Ec
dB
nS
Ec
Ec
Ec
HC
Ou
OJ
xt
XS
XS
XS
"}
(5,1,1) = {"
Or
FY
dB
Ec
Ec
TC
TC
TC
TC
lS
ko
nS
Ec
lV
Ec
jA
nQ
xt
XS
XS
"}
(6,1,1) = {"
Or
Or
Ec
dB
TC
TC
hX
hX
bF
bR
ko
ko
ko
lV
Ec
Ou
xt
xt
xt
XS
"}
(7,1,1) = {"
XS
Ec
Ec
TC
TC
wd
Kd
sJ
hJ
sJ
bR
ko
ko
nS
nS
Ec
FY
xt
xt
XS
"}
(8,1,1) = {"
XS
Ec
Ec
TC
rm
sJ
vq
fu
WY
kU
AS
bR
ko
ko
nS
nS
FY
FY
xt
XS
"}
(9,1,1) = {"
XS
Ec
Ec
TC
cq
sJ
ST
WP
sJ
CK
Xy
fu
Ro
ko
dB
Ec
Fx
FY
XS
XS
"}
(10,1,1) = {"
XS
Ec
Ec
TC
Rq
sJ
LK
sJ
sJ
Gu
sx
ST
SI
TC
Ec
Ec
FY
FY
XS
XS
"}
(11,1,1) = {"
Tn
Ec
Ec
TC
lN
sJ
sJ
vq
sJ
sJ
LK
uA
sJ
TC
Ec
Ec
FY
XS
XS
XS
"}
(12,1,1) = {"
XS
dB
Ec
TC
ew
sJ
sJ
uA
Aa
fu
kU
sJ
sJ
TC
Ec
Ec
XS
XS
XS
XS
"}
(13,1,1) = {"
XS
Ec
Ec
TC
TC
wd
sJ
OE
sJ
ST
Kd
sJ
TC
TC
Ec
Ec
XS
XS
XS
XS
"}
(14,1,1) = {"
Zh
Ec
Ec
Ec
TC
TC
VY
EU
EU
sJ
qD
TC
TC
Ec
Ec
Ec
XS
Oa
XS
XS
"}
(15,1,1) = {"
FY
FY
Ec
Ec
Ec
TC
TC
TC
TC
TC
TC
TC
Ec
Ec
Ec
Ec
Oa
Oa
Oa
XS
"}
(16,1,1) = {"
FY
Fx
FY
Ec
dB
Ec
Ec
Ec
Ec
Ec
dB
Ec
Ec
dB
Ec
Oa
kH
Oa
Oa
XS
"}
(17,1,1) = {"
Oa
FY
FY
xt
Ec
Ec
Ec
dB
Ec
Ec
Ec
Ec
Ec
XS
Oa
Oa
Oa
Oa
Oa
XS
"}
(18,1,1) = {"
Oa
Oa
Oa
xt
xt
xt
XS
XS
CQ
FY
Fx
FY
Or
XS
XS
Oa
Oa
Oa
II
XS
"}
(19,1,1) = {"
XS
Oa
Oa
Oa
xt
XS
XS
GV
XS
FY
FY
Or
XS
XS
XS
Oa
Oa
Oa
XS
XS
"}
(20,1,1) = {"
XS
XS
XS
Oa
XS
XS
XS
XS
XS
XS
FY
Or
XS
XS
XS
XS
XS
XS
XS
XS
"}
