//MAP CONVERTED BY dmm2tgm.py THIS HEADER COMMENT PREVENTS RECONVERSION, DO NOT REMOVE
"a" = (
/turf/open/floor/plating/asteroid/purple/lit/anima,
/area/ruin/anima)
"c" = (
/obj/structure/stone_tile/surrounding,
/obj/structure/stone_tile/center,
/obj/structure/destructible/tribal_torch/lit{
	pixel_y = 13
	},
/turf/open/floor/plating/asteroid/basalt/lava,
/area/ruin/anima)
"d" = (
/obj/structure/stone_tile/block/cracked,
/turf/open/floor/plating/asteroid/purple/lit/anima,
/area/ruin/anima)
"e" = (
/obj/structure/stone_tile/block,
/obj/structure/stone_tile{
	dir = 1
	},
/turf/open/floor/plating/asteroid/basalt/lava,
/area/ruin/anima)
"f" = (
/turf/closed/indestructible/riveted/boss,
/area/ruin/anima)
"g" = (
/obj/structure/stone_tile/slab/cracked{
	dir = 5
	},
/turf/open/floor/plating/asteroid/basalt/lava,
/area/ruin/anima)
"h" = (
/obj/structure/stone_tile/slab/cracked{
	dir = 4
	},
/turf/open/floor/plating/asteroid/purple/lit/anima,
/area/ruin/anima)
"k" = (
/obj/structure/stone_tile/block,
/obj/structure/stone_tile/block/cracked{
	dir = 1
	},
/turf/open/floor/plating/asteroid/basalt/lava,
/area/ruin/anima)
"m" = (
/obj/structure/stone_tile/slab,
/turf/open/floor/plating/asteroid/purple/lit/anima,
/area/ruin/anima)
"s" = (
/obj/structure/stone_tile/block,
/turf/open/floor/plating/asteroid/basalt/lava,
/area/ruin/anima)
"t" = (
/obj/structure/stone_tile/slab,
/turf/open/floor/plating/asteroid/basalt/lava,
/area/ruin/anima)
"u" = (
/obj/structure/stone_tile/surrounding,
/obj/structure/stone_tile/center,
/obj/structure/destructible/tribal_torch/lit{
	pixel_y = 13
	},
/turf/open/floor/plating/asteroid/purple/lit/anima,
/area/ruin/anima)
"v" = (
/obj/structure/stone_tile/surrounding/cracked,
/turf/open/floor/plating/asteroid/basalt/lava,
/area/ruin/anima)
"y" = (
/obj/structure/stone_tile/slab/cracked{
	dir = 6
	},
/turf/open/floor/plating/asteroid/purple/lit/anima,
/area/ruin/anima)
"A" = (
/obj/structure/stone_tile/block/cracked,
/turf/open/floor/plating/asteroid/basalt/lava,
/area/ruin/anima)
"C" = (
/obj/structure/stone_tile/block/cracked{
	dir = 1
	},
/turf/open/floor/plating/asteroid/basalt/lava,
/area/ruin/anima)
"G" = (
/obj/structure/flora/rock/hell,
/turf/open/floor/plating/asteroid/purple/lit/anima,
/area/ruin/anima)
"H" = (
/obj/structure/stone_tile/block/cracked,
/obj/structure/stone_tile/block/cracked{
	dir = 1
	},
/turf/open/floor/plating/asteroid/basalt/lava,
/area/ruin/anima)
"K" = (
/obj/structure/stone_tile/slab/cracked{
	dir = 5
	},
/turf/open/floor/plating/asteroid/purple/lit/anima,
/area/ruin/anima)
"M" = (
/obj/structure/stone_tile/block,
/turf/open/floor/plating/asteroid/purple/lit/anima,
/area/ruin/anima)
"N" = (
/obj/structure/table/wood,
/obj/structure/stone_tile/slab,
/obj/item/reagent_containers/food/snacks/grown/ash_flora/fireblossom,
/turf/open/floor/plating/asteroid/purple/lit/anima,
/area/ruin/anima)
"O" = (
/mob/living/simple_animal/hostile/megafauna/blood_drunk_miner/doom,
/obj/structure/stone_tile/center,
/obj/structure/stone_tile/surrounding_tile,
/obj/structure/stone_tile/surrounding_tile{
	dir = 8
	},
/obj/structure/stone_tile/surrounding_tile{
	dir = 4
	},
/obj/structure/stone_tile/surrounding_tile{
	dir = 1
	},
/turf/open/floor/plating/asteroid/basalt/lava,
/area/ruin/anima)
"Q" = (
/obj/structure/stone_tile/block/cracked{
	dir = 6
	},
/obj/structure/closet/crate/necropolis/tendril,
/turf/open/floor/plating/asteroid/basalt/lava,
/area/ruin/anima)
"R" = (
/obj/structure/stone_tile/surrounding/cracked,
/turf/open/floor/plating/asteroid/purple/lit/anima,
/area/ruin/anima)
"S" = (
/obj/structure/table/wood,
/obj/item/clothing/suit/hooded/cloak/bone{
	pixel_y = 3
	},
/obj/item/shield/riot/goliath{
	pixel_x = -12;
	pixel_y = -6
	},
/obj/item/melee/sword/bone{
	pixel_x = 13;
	pixel_y = -7
	},
/obj/structure/stone_tile/slab,
/turf/open/floor/plating/asteroid/purple/lit/anima,
/area/ruin/anima)
"T" = (
/turf/open/floor/plating/asteroid/basalt/lava,
/area/ruin/anima)
"V" = (
/turf/template_noop,
/area/template_noop)
"W" = (
/obj/structure/flora/rock/hell,
/turf/open/floor/plating/asteroid/basalt/lava,
/area/ruin/anima)
"Y" = (
/obj/structure/stone_tile/slab/cracked{
	dir = 6
	},
/turf/open/floor/plating/asteroid/basalt/lava,
/area/ruin/anima)
"Z" = (
/obj/structure/chair/wood/wings,
/obj/structure/stone_tile/slab,
/turf/open/floor/plating/asteroid/purple/lit/anima,
/area/ruin/anima)

(1,1,1) = {"
V
V
V
V
T
T
T
T
V
V
V
V
V
V
V
"}
(2,1,1) = {"
V
V
V
T
T
T
T
T
T
T
V
V
V
V
V
"}
(3,1,1) = {"
V
V
T
T
T
T
T
a
T
W
T
T
V
V
V
"}
(4,1,1) = {"
V
T
f
f
f
f
a
a
y
T
T
Y
T
V
V
"}
(5,1,1) = {"
a
T
f
Z
N
f
u
a
h
a
T
T
a
V
V
"}
(6,1,1) = {"
a
T
f
e
T
a
m
m
y
a
a
Y
T
T
T
"}
(7,1,1) = {"
a
T
f
Q
t
f
y
y
m
a
a
T
T
T
T
"}
(8,1,1) = {"
a
T
f
f
S
f
u
M
d
m
a
a
a
a
T
"}
(9,1,1) = {"
a
T
T
f
f
f
a
R
a
m
Y
M
T
T
G
"}
(10,1,1) = {"
a
a
T
T
T
T
d
a
K
y
g
T
c
T
T
"}
(11,1,1) = {"
a
a
T
T
g
v
T
C
a
R
a
g
T
T
T
"}
(12,1,1) = {"
a
a
T
W
T
Y
g
T
O
C
A
Y
s
T
T
"}
(13,1,1) = {"
T
a
T
T
T
T
Y
C
v
T
Y
T
T
T
a
"}
(14,1,1) = {"
V
a
a
T
v
g
Y
k
A
H
s
g
T
W
a
"}
(15,1,1) = {"
V
a
a
a
c
T
a
T
Y
g
Y
a
T
a
a
"}
(16,1,1) = {"
V
a
T
a
a
T
T
A
T
a
T
g
T
a
V
"}
(17,1,1) = {"
V
T
T
T
a
a
a
T
T
T
g
c
a
a
V
"}
(18,1,1) = {"
V
V
T
a
T
a
a
T
W
a
a
a
a
a
V
"}
(19,1,1) = {"
V
V
V
a
a
a
a
a
a
a
a
a
V
V
V
"}
(20,1,1) = {"
V
V
V
V
V
V
V
T
T
a
a
V
V
V
V
"}
