//MAP CONVERTED BY dmm2tgm.py THIS HEADER COMMENT PREVENTS RECONVERSION, DO NOT REMOVE
"az" = (
/obj/effect/turf_decal/box/corners{
	dir = 8
	},
/obj/structure/closet/crate/engineering/electrical{
	name = "portable generator crate"
	},
/obj/machinery/power/port_gen/pacman/super,
/obj/item/stack/sheet/mineral/uranium/twenty,
/turf/open/floor/plating,
/area/ship/construction)
"aO" = (
/obj/effect/turf_decal/box/corners{
	dir = 4
	},
/obj/machinery/portable_atmospherics/canister/air,
/turf/open/floor/plating,
/area/ship/construction)
"ci" = (
/obj/structure/closet/crate/large,
/obj/machinery/light/floor,
/obj/item/clothing/shoes/magboots,
/obj/item/clothing/shoes/magboots,
/obj/item/clothing/suit/space/hardsuit/engine/elite,
/obj/item/clothing/suit/space/hardsuit/engine,
/obj/item/clothing/gloves/color/latex/engineering,
/obj/item/clothing/gloves/color/latex/engineering,
/obj/item/clothing/shoes/magboots/advance,
/obj/item/clothing/glasses/meson/sunglasses,
/obj/item/clothing/glasses/meson/sunglasses,
/turf/open/floor/plating,
/area/ship/construction)
"ck" = (
/obj/structure/closet/crate{
	name = "Mining Equipment"
	},
/obj/item/pickaxe,
/obj/item/pickaxe,
/obj/item/mining_scanner,
/obj/item/mining_scanner,
/turf/open/floor/plating,
/area/ship/construction)
"dz" = (
/obj/machinery/door/airlock/survival_pod/glass{
	name = "airtight airlock";
	CanAtmosPass = 0;
	desc = "It opens and closes. This one have new airtight technology"
	},
/turf/open/floor/plating,
/area/ship/construction)
"ev" = (
/obj/machinery/light_switch{
	dir = 1;
	pixel_x = 10;
	pixel_y = -20
	},
/obj/machinery/power/apc/auto_name/directional/north,
/turf/open/floor/plating,
/area/ship/construction)
"eQ" = (
/obj/structure/railing{
	dir = 6
	},
/obj/machinery/light/floor,
/turf/open/floor/plating,
/area/ship/construction)
"fF" = (
/obj/effect/turf_decal/industrial/warning{
	dir = 8
	},
/turf/open/floor/plating,
/area/ship/construction)
"hS" = (
/obj/effect/turf_decal/industrial/warning/corner{
	dir = 4
	},
/obj/structure/railing{
	dir = 4
	},
/turf/open/floor/plating,
/area/ship/construction)
"iE" = (
/obj/effect/turf_decal/box/corners{
	dir = 8
	},
/obj/structure/closet/crate/engineering{
	name = "Engine parts"
	},
/obj/item/circuitboard/machine/shuttle/smes,
/obj/item/circuitboard/machine/shuttle/smes,
/obj/item/circuitboard/machine/shuttle/smes,
/obj/item/circuitboard/machine/shuttle/smes,
/obj/item/circuitboard/machine/shuttle/engine/electric,
/obj/item/circuitboard/machine/shuttle/engine/electric,
/obj/item/circuitboard/machine/shuttle/engine/electric,
/obj/item/circuitboard/machine/shuttle/engine/electric,
/obj/item/circuitboard/machine/shuttle/heater,
/obj/item/circuitboard/machine/shuttle/heater,
/obj/item/circuitboard/machine/shuttle/heater,
/obj/item/circuitboard/machine/shuttle/heater,
/obj/item/circuitboard/machine/shuttle/engine/plasma,
/obj/item/circuitboard/machine/shuttle/engine/plasma,
/obj/item/circuitboard/machine/shuttle/engine/plasma,
/obj/item/circuitboard/machine/shuttle/engine/plasma,
/obj/item/areaeditor/shuttle,
/turf/open/floor/plating,
/area/ship/construction)
"jj" = (
/turf/open/floor/plating,
/area/ship/construction)
"ke" = (
/obj/structure/railing{
	dir = 1
	},
/turf/open/floor/plating,
/area/ship/construction)
"mJ" = (
/obj/effect/turf_decal/box/corners,
/obj/machinery/portable_atmospherics/canister/toxins,
/turf/open/floor/plating,
/area/ship/construction)
"nq" = (
/obj/structure/railing,
/turf/open/floor/plating,
/area/ship/construction)
"nx" = (
/obj/structure/closet/crate/large{
	name = "glass crate"
	},
/obj/item/stack/sheet/glass/fifty{
	pixel_x = -5;
	pixel_y = -5
	},
/obj/item/stack/sheet/glass/fifty,
/obj/item/stack/sheet/plastic/twenty,
/obj/item/stack/sheet/plastic/twenty,
/obj/item/stack/sheet/glass/fifty{
	pixel_x = -5;
	pixel_y = -5
	},
/turf/open/floor/plating,
/area/ship/construction)
"pi" = (
/obj/structure/railing{
	dir = 4
	},
/obj/effect/turf_decal/industrial/warning/corner,
/turf/open/floor/plating,
/area/ship/construction)
"rj" = (
/obj/structure/closet/crate/engineering{
	name = "Engineering Equipment Crate"
	},
/obj/item/clothing/suit/hazardvest,
/obj/item/clothing/suit/hazardvest,
/obj/item/storage/belt/utility,
/obj/item/storage/belt/utility,
/obj/item/stack/tape/industrial,
/obj/item/stack/tape/industrial,
/obj/item/stack/tape/industrial/pro,
/obj/item/clothing/head/welding,
/obj/item/clothing/glasses/welding,
/obj/item/storage/bag/construction,
/obj/item/storage/bag/construction,
/obj/item/clothing/gloves/color/yellow,
/obj/item/clothing/gloves/color/yellow,
/turf/open/floor/plating,
/area/ship/construction)
"rS" = (
/obj/structure/closet/wall/directional/north,
/obj/effect/spawner/lootdrop/ration,
/obj/effect/spawner/lootdrop/ration,
/obj/effect/spawner/lootdrop/ration,
/obj/effect/spawner/lootdrop/ration,
/obj/effect/spawner/lootdrop/ration,
/obj/effect/spawner/lootdrop/ration,
/obj/item/storage/cans/sixbeer,
/obj/item/reagent_containers/food/drinks/waterbottle/large{
	pixel_x = 8;
	pixel_y = -3
	},
/obj/item/reagent_containers/food/drinks/waterbottle/large{
	pixel_x = 1;
	pixel_y = -3
	},
/obj/item/reagent_containers/food/drinks/waterbottle/large{
	pixel_x = 5
	},
/obj/item/reagent_containers/food/snacks/canned/beans{
	pixel_x = -2
	},
/obj/item/reagent_containers/food/snacks/canned/beans{
	pixel_x = 2;
	pixel_y = 3
	},
/obj/item/reagent_containers/food/snacks/canned/beans{
	pixel_x = -5;
	pixel_y = 3
	},
/turf/open/floor/plating,
/area/ship/construction)
"uq" = (
/obj/effect/turf_decal/box/corners{
	dir = 4
	},
/obj/structure/reagent_dispensers/fueltank,
/turf/open/floor/plating,
/area/ship/construction)
"vo" = (
/obj/item/stack/tile/carpet/royalblack/fifty,
/obj/item/stack/tile/carpet/royalblue/fifty,
/obj/item/stack/tile/carpet/purple/fifty,
/obj/item/stack/tile/carpet/red/fifty,
/obj/item/stack/tile/carpet/orange/fifty,
/obj/item/stack/tile/carpet/green/fifty,
/obj/item/stack/tile/carpet/fifty,
/obj/item/stack/tile/carpet/cyan/fifty,
/obj/item/stack/tile/carpet/blue/fifty,
/obj/item/stack/tile/carpet/black/fifty,
/obj/item/stack/sheet/mineral/wood/fifty,
/obj/item/stack/sheet/mineral/wood/fifty,
/obj/effect/turf_decal/box/corners{
	dir = 4
	},
/obj/structure/closet/crate/large{
	name = "wood and carpeting crate"
	},
/turf/open/floor/plating,
/area/ship/construction)
"vs" = (
/obj/structure/closet/crate/engineering{
	name = "autolathe crate"
	},
/obj/item/storage/box/stockparts/basic,
/obj/item/storage/box/stockparts/basic,
/obj/item/circuitboard/machine/autolathe,
/obj/item/storage/box/stockparts/basic,
/turf/open/floor/plating,
/area/ship/construction)
"wd" = (
/obj/structure/closet/crate/engineering/electrical{
	name = "electrical crate"
	},
/obj/item/storage/toolbox/electrical{
	pixel_x = 1;
	pixel_y = 6
	},
/obj/item/stack/tape/industrial/electrical,
/obj/item/clothing/gloves/color/yellow,
/obj/item/multitool,
/obj/item/rcl/pre_loaded,
/obj/item/stack/cable_coil/red,
/obj/item/stack/cable_coil/red,
/obj/item/stack/cable_coil/red,
/obj/item/stack/cable_coil/yellow,
/obj/item/stack/cable_coil/yellow,
/obj/item/stack/cable_coil/yellow,
/obj/item/circuitboard/machine/smes,
/obj/item/circuitboard/machine/cell_charger,
/obj/item/stock_parts/cell/high/empty,
/obj/item/stock_parts/cell/high/empty,
/obj/item/stock_parts/cell/high/empty,
/obj/item/stock_parts/cell/high/empty,
/obj/item/stock_parts/cell/high/empty,
/obj/item/storage/box/lights/mixed,
/turf/open/floor/plating,
/area/ship/construction)
"yQ" = (
/obj/structure/closet/wall/directional/north,
/turf/open/floor/plating,
/area/ship/construction)
"zu" = (
/obj/structure/railing{
	dir = 9
	},
/obj/machinery/light/floor,
/turf/open/floor/plating,
/area/ship/construction)
"BL" = (
/obj/structure/railing{
	dir = 4
	},
/turf/open/floor/plating,
/area/ship/construction)
"Ct" = (
/obj/structure/railing{
	dir = 10
	},
/obj/machinery/light/floor,
/turf/open/floor/plating,
/area/ship/construction)
"Ds" = (
/obj/item/stack/rods/fifty{
	pixel_x = 8
	},
/obj/item/stack/rods/fifty{
	pixel_x = -8
	},
/obj/item/stack/rods/fifty,
/obj/structure/closet/crate/large{
	name = "rebar crate"
	},
/turf/open/floor/plating,
/area/ship/construction)
"Fj" = (
/turf/closed/wall,
/area/ship/construction)
"FI" = (
/obj/item/circuitboard/computer/cargo,
/obj/item/spacecash/bundle/loadsamoney,
/obj/item/spacecash/bundle/loadsamoney,
/obj/item/spacecash/bundle/loadsamoney,
/obj/item/circuitboard/machine/holopad,
/obj/item/spacecash/bundle/loadsamoney,
/obj/item/wallframe/intercom/wideband,
/obj/structure/closet/crate{
	name = "Communications Equipment Crate"
	},
/obj/item/newspaper,
/obj/item/wallframe/newscaster,
/turf/open/floor/plating,
/area/ship/construction)
"GN" = (
/obj/effect/turf_decal/industrial/warning{
	dir = 4
	},
/obj/docking_port/mobile{
	callTime = 250;
	can_move_docking_ports = 1;
	launch_status = 0;
	port_direction = 8;
	preferred_direction = 4
	},
/turf/open/floor/plating,
/area/ship/construction)
"HK" = (
/obj/structure/railing{
	dir = 5
	},
/obj/machinery/light/floor,
/turf/open/floor/plating,
/area/ship/construction)
"HP" = (
/obj/effect/turf_decal/industrial/warning{
	dir = 1
	},
/turf/open/floor/plating,
/area/ship/construction)
"Jz" = (
/obj/machinery/power/ship_gravity/unanchored,
/turf/open/floor/plating,
/area/ship/construction)
"Ld" = (
/obj/structure/frame/computer,
/obj/item/circuitboard/computer/shuttle/helm,
/turf/open/floor/plating,
/area/ship/construction)
"LK" = (
/obj/structure/tank_dispenser{
	pixel_y = 32;
	density = 0
	},
/obj/item/paper/crumpled{
	default_raw_text = "Приветствуем! Благодарим за приобритение нашего корабля модели BYO. Данный тип судна представляет из себя строительную платформу, основу для вашего чудесного корабля, который вам предстоит построить самостоятельно! Строительная платформа укомплектована практически всеми нужными вещами.. Часть из которых, возможно, придётся собирать самостоятельно.. Так же, на корабле всего два костюма для безвоздушной среды, но нам кажется, что вы найдёте им применение. Удачи!";
	name = "Помятая записка"
	},
/turf/open/floor/plating,
/area/ship/construction)
"MO" = (
/obj/effect/turf_decal/industrial/warning,
/turf/open/floor/plating,
/area/ship/construction)
"ND" = (
/obj/item/circuitboard/machine/medical_kiosk,
/obj/item/circuitboard/machine/sleeper,
/obj/item/circuitboard/computer/operating,
/obj/item/circuitboard/computer/med_data,
/obj/item/circuitboard/machine/microwave,
/obj/structure/closet/crate/science{
	name = "technology crate"
	},
/obj/item/stack/circuit_stack/full,
/obj/item/stack/circuit_stack/full,
/obj/item/circuitboard/machine/ore_redemption,
/obj/item/circuitboard/machine/shieldwallgen/atmos,
/obj/item/circuitboard/machine/shieldwallgen/atmos,
/obj/item/circuitboard/machine/rdserver,
/obj/item/circuitboard/computer/rdconsole,
/obj/item/research_notes/loot/genius,
/obj/item/circuitboard/machine/techfab/department/engineering,
/turf/open/floor/plating,
/area/ship/construction)
"Pd" = (
/obj/structure/railing{
	dir = 8
	},
/turf/open/floor/plating,
/area/ship/construction)
"Qz" = (
/obj/effect/turf_decal/box/corners{
	dir = 1
	},
/obj/item/stack/sheet/metal/fifty{
	pixel_x = -5;
	pixel_y = -5
	},
/obj/item/stack/sheet/mineral/titanium/fifty{
	pixel_x = 5;
	pixel_y = -5
	},
/obj/item/stack/sheet/metal/fifty{
	pixel_x = -5;
	pixel_y = -2
	},
/obj/item/stack/sheet/mineral/titanium/fifty{
	pixel_x = 5;
	pixel_y = -2
	},
/obj/item/stack/sheet/metal/fifty{
	pixel_x = -5;
	pixel_y = 1
	},
/obj/item/stack/sheet/mineral/titanium/fifty{
	pixel_x = 5;
	pixel_y = 1
	},
/obj/item/stack/sheet/metal/fifty{
	pixel_x = -5;
	pixel_y = 4
	},
/obj/item/stack/sheet/mineral/titanium/fifty{
	pixel_x = 5;
	pixel_y = 4
	},
/obj/structure/closet/crate/large{
	name = "sheet metal crate"
	},
/turf/open/floor/plating,
/area/ship/construction)
"RZ" = (
/obj/effect/turf_decal/box/corners,
/obj/structure/closet/crate/engineering{
	name = "tools crate"
	},
/obj/item/pipe_dispenser,
/obj/item/storage/toolbox/mechanical{
	pixel_x = 5;
	pixel_y = 5
	},
/obj/item/rcd_ammo/large,
/obj/item/rcd_ammo/large,
/obj/item/rcd_ammo/large,
/obj/item/rcd_ammo/large,
/obj/item/rcd_ammo/large,
/obj/item/rcd_ammo/large,
/obj/item/construction/rcd/combat,
/obj/item/construction/rcd/combat,
/turf/open/floor/plating,
/area/ship/construction)
"SA" = (
/obj/effect/turf_decal/box/corners{
	dir = 1
	},
/obj/structure/closet/crate{
	name = "Mining Equipment"
	},
/obj/item/storage/firstaid/fire,
/obj/item/storage/firstaid/brute,
/turf/open/floor/plating,
/area/ship/construction)
"SK" = (
/obj/effect/turf_decal/box/corners,
/obj/machinery/portable_atmospherics/canister/air,
/turf/open/floor/plating,
/area/ship/construction)
"SN" = (
/obj/machinery/newscaster/directional/south,
/obj/structure/closet/crate,
/obj/item/airlock_painter{
	pixel_x = -5;
	pixel_y = -5
	},
/obj/item/decal_painter,
/obj/item/floor_painter{
	pixel_x = 5;
	pixel_y = 5
	},
/turf/open/floor/plating,
/area/ship/construction)
"Vu" = (
/obj/machinery/cryopod{
	dir = 4
	},
/obj/machinery/computer/cryopod/directional/west,
/obj/machinery/light/floor,
/turf/open/floor/plating,
/area/ship/construction)

(1,1,1) = {"
zu
Pd
Pd
Pd
fF
Pd
Pd
Pd
Ct
"}
(2,1,1) = {"
ke
jj
jj
ck
jj
ND
jj
jj
nq
"}
(3,1,1) = {"
ke
jj
SN
Fj
Fj
Fj
Ld
jj
nq
"}
(4,1,1) = {"
ke
jj
Qz
Fj
Vu
Fj
az
jj
nq
"}
(5,1,1) = {"
ke
jj
nx
Fj
yQ
Fj
FI
jj
nq
"}
(6,1,1) = {"
ke
jj
Ds
Fj
rS
Fj
wd
jj
nq
"}
(7,1,1) = {"
ke
jj
vo
Fj
ev
Fj
RZ
jj
nq
"}
(8,1,1) = {"
HP
jj
jj
dz
jj
dz
jj
jj
MO
"}
(9,1,1) = {"
ke
jj
SA
Fj
LK
Fj
iE
jj
nq
"}
(10,1,1) = {"
ke
jj
rj
Fj
ci
Fj
vs
jj
nq
"}
(11,1,1) = {"
ke
jj
uq
Fj
Fj
Fj
mJ
jj
nq
"}
(12,1,1) = {"
ke
jj
jj
aO
Jz
SK
jj
jj
nq
"}
(13,1,1) = {"
HK
BL
BL
pi
GN
hS
BL
BL
eQ
"}
