//MAP CONVERTED BY dmm2tgm.py THIS HEADER COMMENT PREVENTS RECONVERSION, DO NOT REMOVE
"a" = (
/obj/structure/bed/double{
	dir = 4
	},
/obj/item/bedsheet/double/black{
	dir = 1
	},
/turf/open/floor/carpet/nanoweave/beige,
/area/ship/bridge)
"b" = (
/obj/machinery/atmospherics/pipe/simple/scrubbers/hidden/layer4{
	dir = 4
	},
/obj/machinery/atmospherics/pipe/simple/supply/hidden/layer2{
	dir = 4
	},
/obj/effect/turf_decal/corner/opaque/black/half{
	dir = 1
	},
/obj/machinery/holopad/emergency/command,
/turf/open/floor/plasteel/white,
/area/ship/bridge)
"c" = (
/obj/item/flashlight/seclite,
/obj/item/flashlight/seclite,
/obj/item/flashlight/seclite,
/obj/item/reagent_containers/food/snacks/rationpack,
/obj/item/reagent_containers/food/snacks/rationpack,
/obj/item/reagent_containers/food/snacks/rationpack,
/obj/item/reagent_containers/food/snacks/rationpack,
/obj/item/reagent_containers/food/snacks/rationpack,
/obj/item/reagent_containers/food/snacks/rationpack,
/obj/item/reagent_containers/food/snacks/rationpack,
/obj/item/reagent_containers/food/snacks/rationpack,
/obj/item/reagent_containers/food/snacks/rationpack,
/obj/structure/closet/wall/directional/north,
/obj/machinery/door/window,
/obj/machinery/light/small/directional/north{
	pixel_x = 11
	},
/obj/item/clothing/under/rank/medical/doctor,
/obj/item/clothing/under/rank/medical/doctor,
/turf/open/floor/carpet/nanoweave/beige,
/area/ship/bridge)
"d" = (
/obj/structure/cable{
	icon_state = "0-4"
	},
/obj/machinery/atmospherics/components/unary/outlet_injector/layer4{
	dir = 4
	},
/obj/machinery/power/shuttle/engine/electric/bad{
	dir = 4
	},
/turf/open/floor/plating,
/area/ship/bridge)
"e" = (
/obj/structure/window/reinforced/tinted/frosted{
	dir = 8
	},
/obj/structure/table,
/obj/item/reagent_containers/food/snacks/chocolatebunny{
	pixel_y = 11;
	pixel_x = 6;
	name = "BNUUY";
	desc = "FUCKING BNUUY"
	},
/obj/item/reagent_containers/food/drinks/mug/tea{
	pixel_x = -4
	},
/obj/machinery/power/apc/auto_name/directional/south,
/obj/structure/cable,
/obj/effect/turf_decal/corner/opaque/black/three_quarters{
	dir = 1
	},
/obj/machinery/light_switch{
	dir = 1;
	pixel_x = 11;
	pixel_y = -16
	},
/turf/open/floor/plasteel/white,
/area/ship/bridge)
"f" = (
/obj/machinery/atmospherics/pipe/simple/scrubbers/hidden/layer4{
	dir = 4
	},
/obj/machinery/atmospherics/pipe/simple/supply/hidden/layer2{
	dir = 4
	},
/obj/effect/turf_decal/corner/opaque/black{
	dir = 4
	},
/turf/open/floor/plasteel/white,
/area/ship/bridge)
"g" = (
/obj/machinery/door/window{
	dir = 8
	},
/obj/machinery/atmospherics/pipe/simple/scrubbers/hidden/layer4{
	dir = 4
	},
/obj/machinery/atmospherics/pipe/simple/supply/hidden/layer2{
	dir = 4
	},
/obj/structure/cable{
	icon_state = "2-8"
	},
/obj/effect/turf_decal/corner/opaque/solgovgold/half{
	dir = 8
	},
/obj/effect/turf_decal/techfloor/corner{
	dir = 1
	},
/obj/effect/turf_decal/techfloor/corner{
	dir = 8
	},
/obj/effect/turf_decal/trimline/opaque/lightgrey/warning{
	dir = 8
	},
/turf/open/floor/plasteel/white,
/area/ship/bridge)
"h" = (
/obj/machinery/atmospherics/pipe/simple/supply/hidden/layer2{
	dir = 4
	},
/obj/machinery/atmospherics/pipe/manifold/scrubbers/hidden/layer4,
/obj/effect/turf_decal/corner/opaque/black/half{
	dir = 1
	},
/turf/open/floor/plasteel/white,
/area/ship/bridge)
"i" = (
/obj/machinery/computer/helm/retro{
	dir = 8
	},
/obj/effect/turf_decal/corner/opaque/black/half{
	dir = 4
	},
/turf/open/floor/plasteel/white,
/area/ship/bridge)
"j" = (
/obj/machinery/computer/crew/retro{
	dir = 8
	},
/obj/effect/turf_decal/corner/opaque/black/three_quarters{
	dir = 8
	},
/obj/machinery/light_switch{
	pixel_y = 24
	},
/obj/machinery/button/door{
	id = 74572;
	name = "windows";
	pixel_x = 8;
	pixel_y = 25
	},
/turf/open/floor/plasteel/white,
/area/ship/bridge)
"k" = (
/obj/structure/closet/emcloset/empty{
	anchored = 1
	},
/obj/item/clothing/suit/space/eva,
/obj/item/clothing/suit/space/eva,
/obj/item/clothing/suit/space/eva,
/obj/item/clothing/head/helmet/space/eva,
/obj/item/clothing/head/helmet/space/eva,
/obj/item/clothing/head/helmet/space/eva,
/obj/item/tank/internals/oxygen,
/obj/item/tank/internals/oxygen,
/obj/item/tank/internals/oxygen,
/obj/effect/turf_decal/corner/opaque/black/three_quarters,
/turf/open/floor/plasteel/white,
/area/ship/bridge)
"l" = (
/obj/structure/cable{
	icon_state = "1-2"
	},
/obj/structure/cable{
	d2 = 2;
	icon_state = "0-2";
	pixel_y = 1
	},
/obj/machinery/power/terminal{
	icon_state = "term";
	dir = 8
	},
/obj/machinery/atmospherics/pipe/simple/supply/hidden/layer2{
	dir = 6
	},
/obj/structure/cable{
	icon_state = "2-4";
	tag = null
	},
/obj/machinery/atmospherics/pipe/simple/scrubbers/hidden/layer4{
	dir = 4
	},
/turf/open/floor/plating,
/area/ship/bridge)
"m" = (
/obj/structure/cable{
	icon_state = "1-2"
	},
/obj/structure/cable{
	icon_state = "0-2"
	},
/obj/machinery/power/terminal{
	icon_state = "term";
	dir = 8
	},
/obj/machinery/portable_atmospherics/canister/air,
/obj/machinery/atmospherics/components/unary/portables_connector/layer2{
	dir = 1
	},
/turf/open/floor/plating,
/area/ship/bridge)
"n" = (
/obj/structure/cable{
	icon_state = "0-8"
	},
/obj/machinery/power/smes/shuttle/precharged{
	dir = 4
	},
/obj/structure/window/plasma/reinforced/spawner/west,
/obj/machinery/door/poddoor/shutters{
	dir = 4;
	id = 81631
	},
/obj/machinery/atmospherics/pipe/simple/scrubbers/hidden/layer4{
	dir = 4
	},
/turf/open/floor/plating,
/area/ship/bridge)
"o" = (
/obj/structure/closet/wall/white/med{
	pixel_y = 28;
	dir = 1
	},
/obj/item/storage/firstaid/brute,
/obj/item/storage/firstaid/fire,
/obj/item/storage/firstaid/radiation,
/obj/item/storage/firstaid/toxin,
/obj/item/storage/firstaid/o2,
/obj/effect/turf_decal/corner/opaque/black/half{
	dir = 1
	},
/obj/machinery/light/small/directional/north{
	pixel_x = 16
	},
/obj/item/defibrillator/loaded,
/turf/open/floor/plasteel/white,
/area/ship/bridge)
"p" = (
/obj/structure/chair/sofa/brown{
	dir = 1
	},
/obj/effect/turf_decal/corner/opaque/black/half,
/obj/item/radio/intercom/wideband/directional/south{
	pixel_x = -9
	},
/obj/machinery/newscaster/directional/south{
	pixel_x = 9
	},
/turf/open/floor/plasteel/white,
/area/ship/bridge)
"q" = (
/turf/closed/wall/yesdiag,
/area/ship/bridge)
"r" = (
/obj/structure/cable,
/obj/machinery/power/terminal{
	icon_state = "term";
	dir = 8
	},
/obj/item/storage/box/maid,
/obj/structure/extinguisher_cabinet/directional/east,
/obj/item/trash/sosjerky,
/obj/effect/turf_decal/box,
/obj/machinery/button/door{
	id = 81631;
	name = "Engine Shutters";
	pixel_x = 21;
	pixel_y = 11;
	dir = 8
	},
/obj/machinery/light/small/directional/east{
	pixel_y = -10
	},
/obj/machinery/power/ship_gravity,
/turf/open/floor/plating,
/area/ship/bridge)
"s" = (
/turf/open/floor/plasteel/white,
/area/ship/bridge)
"t" = (
/turf/template_noop,
/area/template_noop)
"u" = (
/obj/structure/window/reinforced/tinted/frosted,
/turf/open/floor/carpet/nanoweave/beige,
/area/ship/bridge)
"v" = (
/obj/structure/window/reinforced/tinted/frosted{
	dir = 8;
	pixel_x = -3
	},
/obj/structure/closet/secure_closet{
	icon_state = "med_secure";
	anchored = 1;
	name = "medical equipment locker"
	},
/obj/item/clothing/suit/apron/surgical{
	pixel_y = 6
	},
/obj/item/clothing/suit/apron/surgical{
	pixel_y = 6
	},
/obj/item/clothing/suit/apron/surgical{
	pixel_y = 6
	},
/obj/item/storage/box/gloves,
/obj/item/storage/box/masks,
/obj/item/storage/belt/medical/webbing,
/obj/item/storage/belt/medical/webbing,
/obj/item/storage/belt/medical,
/obj/item/storage/belt/medical,
/obj/effect/turf_decal/corner/opaque/black/half{
	dir = 8
	},
/obj/item/reagent_containers/glass/bottle/formaldehyde,
/turf/open/floor/plasteel/white,
/area/ship/bridge)
"w" = (
/obj/machinery/atmospherics/pipe/simple/scrubbers/hidden/layer4{
	dir = 4
	},
/obj/machinery/atmospherics/pipe/manifold/supply/hidden/layer2,
/obj/effect/turf_decal/corner/opaque/black/half{
	dir = 1
	},
/turf/open/floor/plasteel/white,
/area/ship/bridge)
"x" = (
/obj/item/clothing/suit/armor/vest/capcarapace/captunic,
/obj/item/binoculars,
/obj/item/clothing/head/beret/captain,
/obj/structure/closet/wall/blue/directional/south,
/obj/effect/turf_decal/corner/opaque/black/half,
/obj/machinery/light/small/directional/south{
	pixel_x = 16
	},
/obj/item/clothing/under/rank/medical/chief_medical_officer,
/obj/item/toy/plush/celadon/hampter/medic,
/obj/item/clothing/suit/armor/vest/capcarapace/duster,
/obj/item/clothing/head/caphat/cowboy,
/turf/open/floor/plasteel/white,
/area/ship/bridge)
"y" = (
/obj/docking_port/mobile{
	port_direction = 4;
	preferred_direction = 4
	},
/obj/machinery/door/airlock/external{
	id_tag = "ext_airl"
	},
/obj/structure/fans/tiny,
/turf/open/floor/plating,
/area/ship/bridge)
"z" = (
/obj/structure/closet/firecloset{
	anchored = 1
	},
/obj/effect/turf_decal/corner/opaque/black/half,
/turf/open/floor/plasteel/white,
/area/ship/bridge)
"B" = (
/obj/machinery/cryopod{
	dir = 4
	},
/obj/structure/window/reinforced/tinted/frosted{
	dir = 8
	},
/obj/structure/window/reinforced/tinted/frosted,
/obj/machinery/computer/helm/viewscreen/directional/north,
/turf/open/floor/carpet/nanoweave/beige,
/area/ship/bridge)
"C" = (
/obj/structure/sign/departments/medbay/alt,
/turf/closed/wall,
/area/ship/bridge)
"D" = (
/obj/effect/spawner/structure/window/reinforced,
/obj/machinery/door/poddoor/shutters{
	dir = 4;
	id = 74572
	},
/turf/open/floor/plating,
/area/ship/bridge)
"E" = (
/obj/machinery/computer/operating/retro,
/obj/structure/window/reinforced/tinted/frosted{
	dir = 8;
	pixel_x = -3
	},
/obj/effect/turf_decal/corner/opaque/black/three_quarters{
	dir = 4
	},
/turf/open/floor/plasteel/white,
/area/ship/bridge)
"F" = (
/obj/effect/turf_decal/corner/opaque/black{
	dir = 8
	},
/turf/open/floor/plasteel/white,
/area/ship/bridge)
"G" = (
/obj/structure/sign/departments/medbay/alt,
/turf/closed/wall/rust,
/area/ship/bridge)
"H" = (
/obj/effect/turf_decal/corner/opaque/black,
/obj/item/clothing/glasses/thermal/eyepatch,
/obj/item/crowbar/power,
/obj/item/crowbar/power,
/obj/item/crowbar/power,
/obj/item/reagent_containers/pill/patch/synthflesh,
/obj/item/reagent_containers/pill/patch/synthflesh,
/obj/item/reagent_containers/pill/patch/synthflesh,
/obj/item/reagent_containers/pill/patch/synthflesh,
/obj/item/reagent_containers/pill/patch/synthflesh,
/obj/item/reagent_containers/pill/patch/synthflesh,
/obj/item/circuitboard/machine/stasis,
/obj/structure/closet/crate/chem{
	name = "new equpment"
	},
/turf/open/floor/plasteel/white,
/area/ship/bridge)
"I" = (
/obj/machinery/atmospherics/components/unary/vent_scrubber/on/layer4{
	dir = 8
	},
/turf/open/floor/plasteel/white,
/area/ship/bridge)
"J" = (
/obj/structure/cable{
	icon_state = "0-8"
	},
/obj/machinery/power/smes/shuttle/precharged{
	dir = 4
	},
/obj/structure/window/plasma/reinforced/spawner/west,
/obj/machinery/door/poddoor/shutters{
	dir = 4;
	id = 81631
	},
/turf/open/floor/plating,
/area/ship/bridge)
"K" = (
/obj/machinery/power/port_gen/pacman/super/not_very{
	anchored = 1
	},
/obj/item/stack/sheet/mineral/uranium/twenty,
/obj/structure/closet/wall/orange/directional/north,
/obj/machinery/power/terminal{
	icon_state = "term";
	dir = 8
	},
/obj/structure/cable{
	icon_state = "0-8"
	},
/obj/effect/turf_decal/corner/opaque/black/three_quarters{
	dir = 8
	},
/obj/effect/turf_decal/box,
/obj/item/stock_parts/capacitor/adv,
/obj/item/stock_parts/micro_laser/high,
/obj/machinery/light/small/directional/north{
	pixel_x = -14
	},
/obj/item/tank/internals/emergency_oxygen/engi,
/obj/item/tank/internals/emergency_oxygen/engi,
/obj/item/tank/internals/emergency_oxygen/engi,
/turf/open/floor/plasteel/white,
/area/ship/bridge)
"L" = (
/obj/structure/chair/comfy/shuttle{
	dir = 4
	},
/turf/open/floor/plasteel/white,
/area/ship/bridge)
"M" = (
/turf/closed/wall/rust,
/area/ship/bridge)
"N" = (
/turf/closed/wall,
/area/ship/bridge)
"O" = (
/obj/effect/spawner/structure/window/reinforced,
/obj/machinery/door/poddoor/shutters{
	id = 74572
	},
/turf/open/floor/plating,
/area/ship/bridge)
"P" = (
/obj/machinery/airalarm/directional/west,
/obj/effect/turf_decal/corner/opaque/orange/half,
/obj/effect/turf_decal/trimline/opaque/bar/warning,
/obj/effect/turf_decal/techfloor/corner,
/obj/effect/turf_decal/techfloor/corner{
	dir = 8
	},
/obj/effect/turf_decal/corner/opaque/black{
	dir = 1
	},
/obj/machinery/light/small/directional/west{
	pixel_y = 14;
	pixel_x = -25
	},
/turf/open/floor/plasteel/white,
/area/ship/bridge)
"Q" = (
/obj/structure/cable{
	d2 = 2;
	icon_state = "0-2";
	pixel_y = 1
	},
/obj/machinery/power/terminal{
	icon_state = "term";
	dir = 8
	},
/obj/structure/closet/wall/orange/directional/east,
/obj/item/storage/toolbox/mechanical,
/obj/item/storage/toolbox/electrical{
	pixel_y = 8
	},
/obj/item/storage/belt/utility/full/engi,
/obj/item/reagent_containers/glass/bottle/welding_fuel,
/obj/item/reagent_containers/glass/bottle/welding_fuel,
/obj/machinery/light/small/directional/east{
	pixel_y = 11
	},
/obj/machinery/autolathe,
/obj/item/stack/sheet/metal/ten,
/obj/item/stack/sheet/glass/five,
/obj/item/stack/sheet/glass/five,
/obj/item/pickaxe/improvised,
/turf/open/floor/plating,
/area/ship/bridge)
"R" = (
/obj/machinery/atmospherics/pipe/simple/scrubbers/hidden/layer4{
	dir = 4
	},
/obj/machinery/atmospherics/components/unary/vent_pump/on/layer2{
	dir = 8
	},
/obj/effect/turf_decal/corner/opaque/black{
	dir = 1
	},
/turf/open/floor/plasteel/white,
/area/ship/bridge)
"S" = (
/obj/structure/chair/sofa/brown/right{
	dir = 1
	},
/obj/effect/turf_decal/corner/opaque/black/half,
/obj/machinery/button/door{
	id = "ext_airl";
	name = "Airlock bolts";
	pixel_x = -1;
	pixel_y = -19;
	dir = 1;
	normaldoorcontrol = 1;
	specialfunctions = 4
	},
/turf/open/floor/plasteel/white,
/area/ship/bridge)
"T" = (
/obj/structure/window/reinforced/tinted/frosted{
	dir = 8
	},
/obj/machinery/power/smes/engineering,
/obj/structure/cable{
	icon_state = "0-8"
	},
/obj/effect/turf_decal/corner/opaque/black/three_quarters{
	dir = 4
	},
/turf/open/floor/plasteel/white,
/area/ship/bridge)
"U" = (
/obj/structure/cable{
	icon_state = "1-2"
	},
/obj/structure/cable{
	d2 = 2;
	icon_state = "0-2";
	pixel_y = 1
	},
/obj/machinery/power/terminal{
	icon_state = "term";
	dir = 8
	},
/obj/structure/cable{
	icon_state = "2-4";
	tag = null
	},
/turf/open/floor/plating,
/area/ship/bridge)
"V" = (
/obj/structure/chair/plastic{
	dir = 1
	},
/obj/effect/turf_decal/corner/opaque/black{
	dir = 4
	},
/turf/open/floor/plasteel/white,
/area/ship/bridge)
"W" = (
/obj/machinery/computer/cargo/retro{
	dir = 8
	},
/obj/effect/turf_decal/corner/opaque/black/three_quarters,
/turf/open/floor/plasteel/white,
/area/ship/bridge)
"X" = (
/obj/structure/table/optable,
/obj/item/storage/backpack/duffelbag/med/surgery{
	pixel_y = 11;
	pixel_x = 12
	},
/obj/item/reagent_containers/medigel/sterilizine{
	pixel_x = 13
	},
/obj/effect/turf_decal/corner/opaque/black/three_quarters{
	dir = 8
	},
/turf/open/floor/plasteel/white,
/area/ship/bridge)
"Y" = (
/obj/structure/cable{
	icon_state = "0-4"
	},
/obj/machinery/power/shuttle/engine/electric/bad{
	dir = 4
	},
/turf/open/floor/plating,
/area/ship/bridge)
"Z" = (
/obj/structure/chair/sofa/brown/left{
	dir = 1
	},
/obj/effect/turf_decal/corner/opaque/black/half,
/obj/machinery/light/small/directional/south,
/turf/open/floor/plasteel/white,
/area/ship/bridge)

(1,1,1) = {"
M
Y
Y
d
Y
Y
N
"}
(2,1,1) = {"
M
J
J
n
J
J
N
"}
(3,1,1) = {"
N
Q
U
l
m
r
G
"}
(4,1,1) = {"
q
N
T
g
e
N
q
"}
(5,1,1) = {"
t
N
K
f
Z
M
t
"}
(6,1,1) = {"
t
N
B
w
p
N
t
"}
(7,1,1) = {"
q
N
c
h
S
N
q
"}
(8,1,1) = {"
C
a
u
b
F
P
y
"}
(9,1,1) = {"
O
E
v
R
s
z
O
"}
(10,1,1) = {"
O
X
V
I
H
k
O
"}
(11,1,1) = {"
q
N
o
L
x
N
q
"}
(12,1,1) = {"
t
M
j
i
W
C
t
"}
(13,1,1) = {"
t
q
D
D
D
q
t
"}
