//MAP CONVERTED BY dmm2tgm.py THIS HEADER COMMENT PREVENTS RECONVERSION, DO NOT REMOVE
"a" = (
/turf/template_noop,
/area/template_noop)
"g" = (
/obj/item/storage/belt/utility/chief/full,
/obj/item/clothing/mask/gas/sechailer,
/obj/item/tank/internals/emergency_oxygen/double,
/obj/item/tank/internals/emergency_oxygen/double,
/obj/item/reagent_containers/food/snacks/rationpack,
/obj/item/reagent_containers/food/snacks/rationpack,
/obj/item/reagent_containers/food/drinks/waterbottle/large,
/obj/structure/cable{
	icon_state = "2-8"
	},
/obj/item/storage/box/survival/medical,
/obj/item/melee/knife/survival,
/obj/structure/closet/wall{
	pixel_y = 31;
	pixel_x = -3;
	dir = 1
	},
/obj/item/storage/firstaid/medical,
/obj/machinery/holopad/emergency/command,
/turf/open/floor/plasteel/dark,
/area/ship/bridge)
"m" = (
/obj/structure/chair/comfy/shuttle{
	dir = 4
	},
/obj/structure/closet/wall{
	pixel_y = 31;
	pixel_x = 3;
	dir = 1
	},
/obj/item/stack/sheet/mineral/plasma/five,
/obj/item/stack/sheet/metal/twenty,
/obj/item/circuitboard/machine/ore_redemption,
/obj/item/circuitboard/machine/autolathe,
/obj/item/pickaxe,
/obj/item/pipe_dispenser,
/obj/item/clothing/suit/space/hardsuit,
/obj/item/areaeditor/shuttle,
/turf/open/floor/plasteel/dark,
/area/ship/bridge)
"q" = (
/obj/item/radio/intercom/wideband{
	pixel_x = 15;
	pixel_y = 1;
	dir = 1
	},
/turf/closed/wall,
/area/ship/bridge)
"t" = (
/obj/effect/turf_decal/industrial/warning{
	dir = 4
	},
/obj/effect/turf_decal/industrial/warning{
	dir = 9
	},
/turf/open/floor/plating,
/area/ship/external/dark)
"v" = (
/obj/machinery/door/airlock/external,
/obj/docking_port/mobile{
	preferred_direction = 4;
	set_dir_on_move = 4
	},
/obj/structure/fans/tiny/invisible,
/turf/open/floor/plasteel/dark,
/area/ship/bridge)
"x" = (
/obj/structure/cable{
	icon_state = "0-4"
	},
/obj/machinery/power/shuttle/engine/electric{
	dir = 4
	},
/turf/open/floor/plating,
/area/ship/bridge)
"y" = (
/obj/machinery/power/port_gen/pacman,
/obj/structure/cable{
	icon_state = "0-1"
	},
/obj/structure/cable{
	icon_state = "1-4"
	},
/turf/open/floor/plasteel/dark,
/area/ship/bridge)
"C" = (
/obj/structure/cable{
	icon_state = "0-8"
	},
/obj/machinery/power/ship_gravity,
/turf/open/floor/plasteel/dark,
/area/ship/bridge)
"F" = (
/obj/machinery/computer/cryopod/directional/east{
	pixel_y = 1;
	pixel_x = -23;
	dir = 8
	},
/obj/machinery/cryopod{
	dir = 4
	},
/obj/structure/cable{
	icon_state = "0-1"
	},
/turf/open/floor/plasteel/dark,
/area/ship/bridge)
"H" = (
/obj/machinery/computer/helm{
	dir = 8;
	pixel_y = 2;
	pixel_x = 8
	},
/obj/machinery/airalarm/directional/north{
	pixel_x = -1;
	pixel_y = 32
	},
/obj/machinery/light/directional/east,
/obj/machinery/newscaster/directional/south,
/turf/open/floor/plasteel/dark,
/area/ship/bridge)
"P" = (
/obj/structure/cable{
	icon_state = "4-8"
	},
/obj/structure/cable{
	icon_state = "2-4"
	},
/turf/open/floor/plasteel/dark,
/area/ship/bridge)
"X" = (
/obj/machinery/light_switch{
	pixel_x = -10;
	pixel_y = 25
	},
/obj/structure/cable{
	icon_state = "4-8"
	},
/obj/structure/window/reinforced/spawner/west,
/obj/structure/cable{
	icon_state = "0-4"
	},
/obj/machinery/power/apc/auto_name/directional/north{
	pixel_y = 30;
	pixel_x = 3
	},
/turf/open/floor/plasteel/dark,
/area/ship/bridge)
"Z" = (
/turf/closed/wall,
/area/ship/bridge)

(1,1,1) = {"
a
Z
x
Z
a
"}
(2,1,1) = {"
t
Z
X
Z
Z
"}
(3,1,1) = {"
a
v
P
F
Z
"}
(4,1,1) = {"
t
q
g
y
Z
"}
(5,1,1) = {"
a
Z
m
C
Z
"}
(6,1,1) = {"
a
Z
H
Z
Z
"}
(7,1,1) = {"
a
Z
Z
Z
a
"}
