//MAP CONVERTED BY dmm2tgm.py THIS HEADER COMMENT PREVENTS RECONVERSION, DO NOT REMOVE
"aS" = (
/obj/structure/cable,
/obj/machinery/power/ship_gravity,
/turf/open/floor/plating,
/area/ship/engineering)
"aW" = (
/obj/structure/cable{
	icon_state = "2-8"
	},
/obj/machinery/atmospherics/components/binary/pump/layer2,
/obj/machinery/light/directional/east,
/obj/structure/cable{
	icon_state = "1-2"
	},
/turf/open/floor/plating,
/area/ship/engineering)
"bQ" = (
/obj/machinery/atmospherics/pipe/simple/supply/hidden/layer2,
/obj/effect/turf_decal/corner/opaque/blue{
	dir = 9
	},
/turf/open/floor/plasteel/dark,
/area/ship/bridge)
"cA" = (
/obj/structure/cable{
	icon_state = "4-8"
	},
/obj/structure/cable{
	icon_state = "1-8"
	},
/obj/machinery/atmospherics/pipe/manifold4w/supply/hidden/layer2,
/obj/machinery/atmospherics/pipe/manifold4w/scrubbers/hidden/layer4,
/obj/docking_port/mobile{
	launch_status = 0;
	port_direction = 2;
	dir = 4;
	preferred_direction = 4
	},
/turf/open/floor/plasteel/dark,
/area/ship/hallway/central)
"da" = (
/obj/machinery/atmospherics/pipe/simple/supply/hidden/layer2{
	dir = 5
	},
/obj/machinery/atmospherics/pipe/simple/scrubbers/hidden/layer4{
	dir = 5;
	pixel_y = 0
	},
/obj/machinery/airalarm/directional/west,
/obj/effect/turf_decal/corner/opaque/bottlegreen/three_quarters{
	dir = 4
	},
/turf/open/floor/plasteel/dark,
/area/ship/crew/hydroponics)
"dj" = (
/obj/structure/cable{
	icon_state = "1-8"
	},
/obj/machinery/atmospherics/pipe/simple/scrubbers/hidden/layer4{
	dir = 9
	},
/obj/machinery/atmospherics/pipe/simple/supply/hidden/layer2{
	dir = 9
	},
/turf/open/floor/plasteel/dark,
/area/ship/crew/hydroponics)
"dX" = (
/obj/structure/window/reinforced,
/obj/structure/flora/ausbushes/ywflowers,
/turf/open/floor/grass,
/area/ship/crew/hydroponics)
"fh" = (
/obj/machinery/power/terminal{
	dir = 8
	},
/obj/structure/cable{
	icon_state = "0-4"
	},
/obj/machinery/atmospherics/components/unary/vent_pump/on/layer2{
	dir = 4
	},
/turf/open/floor/plating,
/area/ship/engineering)
"fv" = (
/obj/structure/cable{
	icon_state = "4-8"
	},
/obj/machinery/atmospherics/pipe/simple/supply/visible/layer2{
	dir = 8
	},
/obj/machinery/door/airlock/engineering/glass{
	req_access_txt = "35";
	dir = 8
	},
/obj/machinery/atmospherics/pipe/simple/scrubbers/visible/layer4{
	dir = 4
	},
/obj/machinery/door/firedoor/border_only{
	dir = 8
	},
/obj/machinery/door/firedoor/border_only{
	dir = 4
	},
/turf/open/floor/plating,
/area/ship/engineering)
"hd" = (
/obj/effect/turf_decal/corner/opaque/bottlegreen/half{
	dir = 1
	},
/turf/open/floor/plasteel/dark,
/area/ship/crew/hydroponics)
"hn" = (
/obj/structure/rack,
/obj/item/storage/toolbox/mechanical{
	pixel_y = -1
	},
/obj/item/storage/toolbox/electrical{
	pixel_y = 5
	},
/obj/item/storage/box/disks_plantgene,
/obj/item/storage/box/disks_plantgene,
/obj/item/storage/box/disks_plantgene,
/obj/machinery/atmospherics/pipe/simple/scrubbers/visible/layer4{
	dir = 4
	},
/turf/open/floor/plating,
/area/ship/engineering)
"ho" = (
/obj/structure/cable{
	icon_state = "1-2"
	},
/obj/machinery/atmospherics/pipe/simple/supply/hidden/layer2{
	dir = 1
	},
/obj/structure/cable{
	icon_state = "0-2"
	},
/obj/machinery/power/apc/auto_name/directional/west,
/obj/machinery/atmospherics/pipe/simple/scrubbers/hidden/layer4{
	dir = 1
	},
/obj/machinery/light_switch{
	pixel_y = -12;
	pixel_x = -19;
	dir = 4
	},
/obj/machinery/firealarm/directional/west{
	pixel_y = 0;
	pixel_x = -41
	},
/turf/open/floor/plasteel/dark,
/area/ship/crew/hydroponics)
"hK" = (
/obj/machinery/power/smes/engineering,
/obj/structure/cable{
	icon_state = "0-2"
	},
/turf/open/floor/plating,
/area/ship/engineering)
"iq" = (
/obj/machinery/seed_extractor,
/turf/open/floor/plasteel/dark,
/area/ship/crew/hydroponics)
"iN" = (
/obj/structure/tank_dispenser/oxygen,
/obj/machinery/firealarm/directional/east,
/obj/effect/turf_decal/corner/opaque/brown/three_quarters,
/turf/open/floor/plasteel/dark,
/area/ship/cargo)
"iZ" = (
/obj/machinery/hydroponics/constructable,
/obj/machinery/firealarm/directional/south,
/obj/effect/turf_decal/corner/opaque/bottlegreen/half,
/turf/open/floor/plasteel/dark,
/area/ship/crew/hydroponics)
"jG" = (
/obj/machinery/power/smes/shuttle/precharged{
	dir = 4
	},
/obj/structure/window/reinforced/spawner{
	dir = 8
	},
/obj/structure/cable{
	icon_state = "0-8"
	},
/obj/machinery/door/poddoor{
	dir = 4;
	id = "flowerengines"
	},
/turf/open/floor/plating,
/area/ship/engineering)
"kb" = (
/obj/structure/flora/ausbushes/sunnybush{
	pixel_y = -3;
	pixel_x = -14
	},
/obj/structure/flora/tree/chapel{
	pixel_x = -24;
	pixel_y = -26;
	density = 0
	},
/turf/open/floor/grass,
/area/ship/crew/hydroponics)
"kI" = (
/turf/open/floor/grass,
/area/ship/crew/hydroponics)
"lz" = (
/obj/structure/cable{
	icon_state = "1-2"
	},
/obj/machinery/button/door{
	dir = 8;
	id = "flowerengines";
	name = "Bridge Lockdown";
	pixel_x = 21;
	pixel_y = 0
	},
/obj/machinery/atmospherics/pipe/simple/supply/visible/layer2{
	dir = 1
	},
/turf/open/floor/plating,
/area/ship/engineering)
"mc" = (
/obj/machinery/atmospherics/components/unary/vent_pump/on/layer2{
	dir = 8
	},
/obj/effect/turf_decal/corner/opaque/brown/half,
/turf/open/floor/plasteel/dark,
/area/ship/cargo)
"nu" = (
/obj/structure/reagent_dispensers/watertank/high,
/turf/open/floor/plating,
/area/ship/engineering)
"oa" = (
/obj/machinery/atmospherics/pipe/simple/supply/hidden/layer2{
	dir = 5
	},
/obj/effect/turf_decal/corner/opaque/blue{
	dir = 9
	},
/turf/open/floor/plasteel/dark,
/area/ship/bridge)
"og" = (
/obj/effect/turf_decal/corner/opaque/bottlegreen/three_quarters{
	dir = 8
	},
/turf/open/floor/plasteel/dark,
/area/ship/crew/hydroponics)
"oV" = (
/obj/machinery/door/poddoor{
	id = "flowerdoors";
	name = "Cargo Bay Blast Door";
	dir = 1
	},
/obj/machinery/door/firedoor/border_only,
/obj/machinery/door/firedoor/border_only{
	dir = 1
	},
/turf/open/floor/plasteel/tech,
/area/ship/cargo)
"qS" = (
/obj/effect/spawner/structure/window/reinforced,
/turf/open/floor/plating,
/area/ship/crew/hydroponics)
"rb" = (
/obj/machinery/atmospherics/components/unary/vent_scrubber/on/layer4{
	dir = 8
	},
/obj/machinery/atmospherics/pipe/simple/supply/hidden/layer2{
	dir = 4
	},
/obj/machinery/light/directional/north,
/obj/effect/turf_decal/corner/opaque/bottlegreen/half{
	dir = 1
	},
/turf/open/floor/plasteel/dark,
/area/ship/crew/hydroponics)
"rE" = (
/obj/structure/window/reinforced{
	dir = 1
	},
/obj/structure/flora/ausbushes/leafybush{
	pixel_y = -6;
	pixel_x = -7
	},
/turf/open/floor/grass,
/area/ship/crew/hydroponics)
"sq" = (
/obj/effect/spawner/structure/window/reinforced,
/obj/machinery/door/poddoor/shutters{
	id = "flowerwindows";
	dir = 8
	},
/obj/machinery/door/poddoor/shutters{
	id = "flowerwindows";
	dir = 8
	},
/turf/open/floor/plating,
/area/ship/bridge)
"ss" = (
/obj/structure/cable{
	icon_state = "1-4"
	},
/obj/structure/cable{
	icon_state = "1-2"
	},
/obj/machinery/atmospherics/pipe/simple/supply/visible/layer2{
	dir = 5
	},
/obj/machinery/atmospherics/pipe/manifold/scrubbers/hidden/layer4{
	dir = 1
	},
/turf/open/floor/plating,
/area/ship/engineering)
"sQ" = (
/obj/machinery/door/airlock/public/glass{
	req_access_txt = "35";
	dir = 1
	},
/obj/machinery/door/firedoor/border_only,
/obj/machinery/door/firedoor/border_only{
	dir = 1
	},
/obj/effect/turf_decal/corner/opaque/bottlegreen/half,
/turf/open/floor/plasteel/dark,
/area/ship/crew/hydroponics)
"th" = (
/obj/machinery/computer/cargo{
	dir = 8
	},
/obj/effect/turf_decal/corner/opaque/blue/half{
	dir = 4
	},
/turf/open/floor/plasteel/dark,
/area/ship/bridge)
"ue" = (
/obj/machinery/atmospherics/components/unary/vent_pump/on/layer2{
	dir = 8
	},
/obj/effect/turf_decal/corner/opaque/bottlegreen/half{
	dir = 1
	},
/turf/open/floor/plasteel/dark,
/area/ship/crew/hydroponics)
"uA" = (
/obj/structure/cable{
	icon_state = "4-8"
	},
/obj/machinery/atmospherics/pipe/simple/scrubbers/hidden/layer4{
	dir = 8
	},
/obj/machinery/atmospherics/pipe/simple/supply/hidden/layer2{
	dir = 10
	},
/obj/effect/turf_decal/corner/opaque/blue/three_quarters{
	dir = 4
	},
/turf/open/floor/plasteel/dark,
/area/ship/bridge)
"uU" = (
/obj/machinery/autolathe,
/obj/item/stack/sheet/glass{
	amount = 30
	},
/obj/item/stack/sheet/metal{
	amount = 30
	},
/obj/machinery/button/shieldwallgen{
	id = "flower_cargofield";
	pixel_x = 6;
	pixel_y = 27
	},
/obj/machinery/button/door{
	id = "flowerdoors";
	name = "Blast Door Control";
	pixel_x = -4;
	pixel_y = 28
	},
/obj/effect/turf_decal/industrial/warning/corner{
	dir = 1
	},
/obj/machinery/light/directional/east,
/obj/effect/turf_decal/corner/opaque/brown/three_quarters{
	dir = 8
	},
/turf/open/floor/plasteel/dark,
/area/ship/cargo)
"vj" = (
/obj/machinery/door/airlock/public/glass{
	req_access_txt = "35"
	},
/obj/machinery/atmospherics/pipe/simple/supply/hidden/layer2{
	dir = 1
	},
/obj/machinery/atmospherics/pipe/simple/scrubbers/hidden/layer4{
	dir = 1
	},
/obj/machinery/door/firedoor/border_only,
/obj/machinery/door/firedoor/border_only{
	dir = 1
	},
/obj/effect/turf_decal/corner/opaque/bottlegreen/half,
/turf/open/floor/plasteel/dark,
/area/ship/crew/hydroponics)
"wr" = (
/obj/machinery/atmospherics/pipe/simple/scrubbers/visible/layer4{
	dir = 4
	},
/obj/structure/window/reinforced/spawner{
	dir = 8
	},
/obj/machinery/door/poddoor{
	dir = 4;
	id = "flowerengines"
	},
/turf/open/floor/plating,
/area/ship/engineering)
"xc" = (
/turf/closed/wall/r_wall,
/area/ship/crew/hydroponics)
"yq" = (
/obj/effect/spawner/structure/window/reinforced,
/obj/machinery/door/poddoor/shutters{
	id = "flowerwindows";
	dir = 8
	},
/turf/open/floor/plating,
/area/ship/bridge)
"yG" = (
/obj/machinery/cryopod{
	dir = 1
	},
/obj/machinery/computer/cryopod/directional/west{
	dir = 2;
	pixel_x = 0;
	pixel_y = -17
	},
/obj/machinery/light_switch{
	pixel_y = 0;
	pixel_x = -24;
	dir = 4
	},
/obj/effect/turf_decal/corner/opaque/blue/three_quarters,
/obj/effect/turf_decal/corner/opaque/blue/three_quarters{
	dir = 8
	},
/turf/open/floor/plasteel/dark,
/area/ship/bridge)
"zn" = (
/obj/structure/cable{
	icon_state = "4-8"
	},
/obj/machinery/atmospherics/components/unary/vent_scrubber/on/layer4{
	dir = 4
	},
/obj/effect/turf_decal/corner/opaque/brown/half,
/turf/open/floor/plasteel/dark,
/area/ship/cargo)
"AB" = (
/obj/structure/cable{
	icon_state = "4-8"
	},
/obj/machinery/atmospherics/pipe/simple/scrubbers/hidden/layer4{
	dir = 8
	},
/obj/machinery/atmospherics/pipe/simple/supply/hidden/layer2{
	dir = 4
	},
/turf/open/floor/plasteel/dark,
/area/ship/hallway/central)
"AF" = (
/turf/template_noop,
/area/template_noop)
"AX" = (
/obj/machinery/power/terminal{
	dir = 8
	},
/obj/structure/cable{
	icon_state = "0-4"
	},
/obj/structure/cable,
/turf/open/floor/plating,
/area/ship/engineering)
"Cf" = (
/obj/machinery/holopad/emergency/command,
/turf/open/floor/plasteel/dark,
/area/ship/crew/hydroponics)
"CA" = (
/obj/machinery/plantgenes{
	pixel_y = 7
	},
/obj/structure/table/wood,
/obj/machinery/atmospherics/components/unary/vent_scrubber/on/layer4,
/obj/machinery/light/directional/north,
/turf/open/floor/plasteel/dark,
/area/ship/crew/hydroponics)
"CK" = (
/turf/closed/wall/r_wall,
/area/ship/cargo)
"CM" = (
/obj/effect/turf_decal/corner/opaque/blue/three_quarters{
	dir = 1
	},
/turf/open/floor/plasteel/dark,
/area/ship/bridge)
"Ey" = (
/obj/item/clothing/suit/hazardvest{
	desc = "A high-visibility lifejacket complete with whistle and slot for oxygen tanks.";
	name = "emergency lifejacket"
	},
/obj/item/clothing/head/hardhat/mining,
/obj/item/gps/mining,
/obj/item/gps/mining,
/obj/item/clothing/glasses/meson/prescription,
/obj/item/clothing/glasses/meson,
/obj/item/t_scanner/adv_mining_scanner/lesser,
/obj/item/gun/energy/kinetic_accelerator,
/obj/item/storage/bag/ore,
/obj/structure/closet/wall/directional/north{
	name = "equipment closet"
	},
/obj/machinery/power/apc/auto_name/directional/west,
/obj/structure/cable{
	icon_state = "0-2"
	},
/obj/effect/turf_decal/industrial/warning/corner{
	dir = 4
	},
/obj/machinery/light_switch{
	pixel_y = -14;
	pixel_x = -19;
	dir = 4
	},
/obj/effect/turf_decal/corner/opaque/brown/three_quarters{
	dir = 4
	},
/turf/open/floor/plasteel/dark,
/area/ship/cargo)
"EV" = (
/obj/machinery/vending/hydroseeds{
	all_items_free = 1
	},
/obj/effect/turf_decal/corner/opaque/bottlegreen/half,
/turf/open/floor/plasteel/dark,
/area/ship/crew/hydroponics)
"Fd" = (
/obj/machinery/atmospherics/pipe/simple/supply/hidden/layer2,
/obj/structure/chair/comfy/beige/directional/east,
/obj/effect/turf_decal/corner/opaque/blue{
	dir = 9
	},
/turf/open/floor/plasteel/dark,
/area/ship/bridge)
"Fi" = (
/turf/closed/wall/r_wall,
/area/ship/bridge)
"Fp" = (
/turf/closed/wall/r_wall,
/area/ship/engineering)
"FE" = (
/obj/machinery/power/terminal{
	dir = 8
	},
/obj/structure/cable{
	icon_state = "0-4"
	},
/obj/machinery/atmospherics/components/unary/vent_scrubber/on/layer4{
	dir = 4
	},
/turf/open/floor/plating,
/area/ship/engineering)
"FK" = (
/obj/structure/cable{
	icon_state = "2-8"
	},
/obj/machinery/atmospherics/pipe/simple/supply/hidden/layer2{
	dir = 6
	},
/obj/machinery/atmospherics/pipe/simple/scrubbers/hidden/layer4{
	dir = 10
	},
/obj/structure/cable{
	icon_state = "1-2"
	},
/obj/effect/turf_decal/corner/opaque/brown/half,
/turf/open/floor/plasteel/dark,
/area/ship/cargo)
"FQ" = (
/obj/structure/cable{
	icon_state = "1-8"
	},
/obj/effect/turf_decal/industrial/warning{
	dir = 1
	},
/turf/open/floor/plasteel/dark,
/area/ship/cargo)
"FZ" = (
/obj/structure/window/reinforced{
	dir = 8
	},
/obj/structure/window/reinforced{
	dir = 1
	},
/obj/structure/flora/ausbushes/ywflowers,
/turf/open/floor/grass,
/area/ship/crew/hydroponics)
"Hd" = (
/obj/structure/window/fulltile,
/obj/structure/grille,
/turf/open/floor/plating,
/area/ship/crew/hydroponics)
"HI" = (
/obj/machinery/airalarm/directional/west,
/obj/structure/cable{
	icon_state = "1-4"
	},
/obj/item/kirbyplants/random,
/obj/effect/turf_decal/corner/opaque/brown/three_quarters{
	dir = 1
	},
/turf/open/floor/plasteel/dark,
/area/ship/cargo)
"Ih" = (
/obj/structure/bed,
/obj/structure/curtain/bounty,
/obj/item/bedsheet/random,
/obj/machinery/light/directional/north,
/obj/machinery/firealarm/directional/east,
/obj/effect/turf_decal/corner/opaque/blue/three_quarters{
	dir = 8
	},
/obj/effect/turf_decal/corner/opaque/blue/three_quarters,
/turf/open/floor/plasteel/dark,
/area/ship/bridge)
"IL" = (
/obj/machinery/hydroponics/constructable,
/obj/machinery/light/directional/south,
/obj/effect/turf_decal/corner/opaque/bottlegreen/half,
/turf/open/floor/plasteel/dark,
/area/ship/crew/hydroponics)
"Jb" = (
/obj/machinery/door/airlock/command/glass{
	dir = 4;
	req_access_txt = "35"
	},
/obj/structure/cable{
	icon_state = "4-8"
	},
/obj/machinery/atmospherics/pipe/simple/scrubbers/hidden/layer4{
	dir = 8
	},
/obj/machinery/atmospherics/pipe/simple/supply/hidden/layer2{
	dir = 4
	},
/obj/machinery/door/firedoor/border_only{
	dir = 4
	},
/obj/machinery/door/firedoor/border_only{
	dir = 8
	},
/obj/effect/turf_decal/corner/opaque/blue/half{
	dir = 4
	},
/turf/open/floor/plasteel/dark,
/area/ship/bridge)
"JD" = (
/obj/structure/cable{
	icon_state = "0-8"
	},
/obj/structure/table/wood,
/obj/item/radio/intercom/wideband/directional/north,
/obj/machinery/atmospherics/components/unary/vent_scrubber/on/layer4{
	dir = 8
	},
/obj/machinery/power/apc/auto_name/directional/east,
/obj/machinery/button/door{
	dir = 8;
	id = "flowerwindows";
	name = "Bridge Lockdown";
	pixel_x = 1;
	pixel_y = 3
	},
/obj/effect/turf_decal/corner/opaque/blue/three_quarters{
	dir = 8
	},
/turf/open/floor/plasteel/dark,
/area/ship/bridge)
"Ku" = (
/turf/open/floor/plating,
/area/ship/engineering)
"KD" = (
/obj/structure/table/wood,
/obj/machinery/atmospherics/components/unary/vent_pump/on/layer2{
	dir = 8
	},
/obj/machinery/microwave{
	pixel_y = 5;
	pixel_x = -1
	},
/obj/effect/turf_decal/corner/opaque/blue/half{
	dir = 4
	},
/turf/open/floor/plasteel/dark,
/area/ship/bridge)
"KN" = (
/obj/machinery/power/port_gen/pacman,
/obj/structure/cable{
	icon_state = "0-4"
	},
/obj/item/stack/sheet/mineral/plasma{
	amount = 25
	},
/turf/open/floor/plating,
/area/ship/engineering)
"KR" = (
/obj/machinery/door/airlock/public/glass{
	req_access_txt = "35";
	dir = 8
	},
/obj/structure/cable{
	icon_state = "4-8"
	},
/obj/machinery/atmospherics/pipe/simple/supply/hidden/layer2{
	dir = 4
	},
/obj/machinery/atmospherics/pipe/simple/scrubbers/hidden/layer4{
	dir = 8
	},
/obj/machinery/door/firedoor/border_only{
	dir = 8
	},
/obj/machinery/door/firedoor/border_only{
	dir = 4
	},
/turf/open/floor/plasteel/dark,
/area/ship/crew/hydroponics)
"Lc" = (
/obj/machinery/chem_dispenser/mutagensaltpeter,
/obj/machinery/light/directional/east,
/obj/effect/turf_decal/corner/opaque/bottlegreen/three_quarters,
/turf/open/floor/plasteel/dark,
/area/ship/crew/hydroponics)
"Lm" = (
/obj/machinery/door/firedoor/border_only{
	dir = 4
	},
/obj/machinery/door/firedoor/border_only{
	dir = 8
	},
/obj/effect/turf_decal/corner/opaque/bottlegreen/half{
	dir = 8
	},
/obj/effect/turf_decal/corner/opaque/blue/half{
	dir = 4
	},
/obj/machinery/door/airlock/command/glass{
	dir = 4;
	req_access_txt = "35"
	},
/turf/open/floor/plasteel/dark,
/area/ship/bridge)
"Mu" = (
/obj/machinery/biogenerator,
/obj/machinery/light/directional/north,
/turf/open/floor/plasteel/dark,
/area/ship/crew/hydroponics)
"MF" = (
/obj/structure/table/wood,
/obj/machinery/smartfridge/disks,
/obj/machinery/atmospherics/components/unary/vent_pump/on/layer2,
/turf/open/floor/plasteel/dark,
/area/ship/crew/hydroponics)
"Nm" = (
/obj/structure/cable{
	icon_state = "0-2"
	},
/obj/machinery/power/shieldwallgen/atmos/roundstart{
	dir = 8;
	id = "flower_cargofield";
	locked = 1
	},
/obj/machinery/door/poddoor{
	id = "flowerdoors";
	name = "Cargo Bay Blast Door";
	dir = 1
	},
/obj/machinery/door/firedoor/border_only,
/obj/machinery/door/firedoor/border_only{
	dir = 1
	},
/turf/open/floor/plasteel/tech,
/area/ship/cargo)
"Nr" = (
/obj/structure/window/reinforced{
	dir = 8
	},
/obj/structure/window/reinforced,
/obj/structure/flora/ausbushes/leafybush,
/turf/open/floor/grass,
/area/ship/crew/hydroponics)
"Nv" = (
/obj/effect/spawner/structure/window/reinforced,
/turf/open/floor/plating,
/area/ship/cargo)
"Op" = (
/obj/machinery/atmospherics/pipe/simple/scrubbers/hidden/layer4{
	dir = 8
	},
/obj/machinery/atmospherics/pipe/simple/supply/hidden/layer2{
	dir = 4
	},
/obj/effect/turf_decal/corner/opaque/bottlegreen/half{
	dir = 1
	},
/turf/open/floor/plasteel/dark,
/area/ship/crew/hydroponics)
"OF" = (
/obj/machinery/hydroponics/constructable,
/obj/effect/turf_decal/corner/opaque/bottlegreen/half,
/turf/open/floor/plasteel/dark,
/area/ship/crew/hydroponics)
"ON" = (
/obj/machinery/power/terminal{
	dir = 8
	},
/obj/structure/cable{
	icon_state = "0-4"
	},
/obj/structure/cable{
	icon_state = "0-4"
	},
/turf/open/floor/plating,
/area/ship/engineering)
"OQ" = (
/obj/machinery/atmospherics/components/unary/outlet_injector/on/layer4{
	dir = 4
	},
/turf/open/floor/plating,
/area/ship/external)
"OV" = (
/obj/structure/cable{
	icon_state = "2-4"
	},
/obj/machinery/atmospherics/pipe/simple/supply/hidden/layer2{
	dir = 6
	},
/obj/machinery/airalarm/directional/west,
/obj/machinery/atmospherics/pipe/manifold/scrubbers/hidden/layer4{
	dir = 8
	},
/turf/open/floor/plasteel/dark,
/area/ship/crew/hydroponics)
"Pu" = (
/obj/structure/sink{
	dir = 4;
	pixel_x = -13;
	pixel_y = 4
	},
/turf/open/floor/hangar/plasteel/white,
/area/ship/crew/hydroponics)
"PH" = (
/obj/structure/cable{
	icon_state = "1-2"
	},
/obj/structure/cable{
	icon_state = "2-8"
	},
/obj/machinery/airalarm/directional/east,
/obj/machinery/atmospherics/pipe/manifold/supply/visible/layer2{
	dir = 4
	},
/turf/open/floor/plating,
/area/ship/engineering)
"Qg" = (
/obj/structure/cable{
	icon_state = "1-4"
	},
/obj/effect/turf_decal/industrial/warning{
	dir = 1
	},
/turf/open/floor/plasteel/dark,
/area/ship/cargo)
"Qv" = (
/obj/structure/cable{
	icon_state = "1-2"
	},
/obj/structure/cable{
	icon_state = "1-8"
	},
/obj/structure/cable{
	icon_state = "0-8"
	},
/obj/machinery/power/apc/auto_name/directional/east,
/obj/machinery/atmospherics/pipe/simple/scrubbers/visible/layer4{
	dir = 9
	},
/turf/open/floor/plating,
/area/ship/engineering)
"Qy" = (
/obj/machinery/power/terminal{
	dir = 8
	},
/obj/structure/cable{
	icon_state = "0-2"
	},
/obj/machinery/atmospherics/components/unary/portables_connector/visible/layer2,
/obj/machinery/firealarm/directional/east,
/turf/open/floor/plating,
/area/ship/engineering)
"QD" = (
/obj/effect/spawner/structure/window/reinforced,
/obj/machinery/door/poddoor/shutters{
	id = "flowerwindows"
	},
/turf/open/floor/plating,
/area/ship/crew/hydroponics)
"Rk" = (
/obj/structure/cable{
	icon_state = "1-8"
	},
/obj/structure/cable{
	icon_state = "1-2"
	},
/obj/machinery/light_switch{
	pixel_y = 0;
	pixel_x = 23;
	dir = 8
	},
/turf/open/floor/plating,
/area/ship/engineering)
"Rw" = (
/obj/structure/cable{
	icon_state = "4-8"
	},
/obj/machinery/atmospherics/pipe/simple/scrubbers/hidden/layer4{
	dir = 8
	},
/obj/machinery/atmospherics/pipe/simple/supply/hidden/layer2{
	dir = 4
	},
/turf/open/floor/plasteel/dark,
/area/ship/crew/hydroponics)
"RC" = (
/obj/machinery/computer/helm{
	dir = 8
	},
/obj/effect/turf_decal/corner/opaque/blue/half{
	dir = 4
	},
/turf/open/floor/plasteel/dark,
/area/ship/bridge)
"So" = (
/obj/machinery/power/shuttle/engine/electric{
	dir = 4
	},
/obj/structure/cable{
	icon_state = "0-4"
	},
/turf/open/floor/plating,
/area/ship/engineering)
"Sy" = (
/turf/open/floor/plasteel/dark,
/area/ship/crew/hydroponics)
"Ta" = (
/obj/structure/cable{
	icon_state = "0-2"
	},
/obj/machinery/power/shieldwallgen/atmos/roundstart{
	dir = 4;
	id = "flower_cargofield";
	locked = 1
	},
/obj/machinery/door/poddoor{
	id = "flowerdoors";
	name = "Cargo Bay Blast Door";
	dir = 1
	},
/obj/machinery/door/firedoor/border_only,
/obj/machinery/door/firedoor/border_only{
	dir = 1
	},
/turf/open/floor/plasteel/tech,
/area/ship/cargo)
"Td" = (
/obj/structure/cable{
	icon_state = "0-8"
	},
/obj/structure/cable{
	icon_state = "4-8"
	},
/obj/machinery/atmospherics/pipe/simple/scrubbers/hidden/layer4{
	dir = 8
	},
/obj/machinery/atmospherics/pipe/manifold/supply/hidden/layer2,
/turf/open/floor/plasteel/dark,
/area/ship/crew/hydroponics)
"TE" = (
/obj/structure/cable{
	icon_state = "1-2"
	},
/obj/structure/cable{
	icon_state = "1-8"
	},
/obj/machinery/light/directional/east,
/turf/open/floor/plating,
/area/ship/engineering)
"UO" = (
/obj/machinery/door/airlock/freezer{
	dir = 8;
	req_access_txt = "35"
	},
/obj/effect/turf_decal/corner/opaque/bottlegreen/half{
	dir = 4
	},
/turf/open/floor/hangar/plasteel/white,
/area/ship/crew/hydroponics)
"Vi" = (
/obj/structure/cable{
	icon_state = "2-4"
	},
/obj/structure/cable{
	icon_state = "2-8"
	},
/obj/effect/turf_decal/industrial/warning{
	dir = 1
	},
/turf/open/floor/plasteel/dark,
/area/ship/cargo)
"Wo" = (
/obj/structure/toilet{
	pixel_y = 10
	},
/obj/machinery/light/directional/north,
/turf/open/floor/hangar/plasteel/white,
/area/ship/crew/hydroponics)
"WT" = (
/obj/effect/turf_decal/corner/opaque/bottlegreen/three_quarters{
	dir = 1
	},
/turf/open/floor/plasteel/dark,
/area/ship/crew/hydroponics)
"Ze" = (
/obj/machinery/door/poddoor/shutters{
	id = "flowerwindows"
	},
/obj/effect/spawner/structure/window/reinforced,
/turf/open/floor/plating,
/area/ship/crew/hydroponics)
"ZA" = (
/obj/structure/cable{
	icon_state = "1-2"
	},
/obj/machinery/door/airlock/mining/glass{
	req_access_txt = "35"
	},
/obj/machinery/atmospherics/pipe/simple/supply/hidden/layer2{
	dir = 1
	},
/obj/machinery/atmospherics/pipe/simple/scrubbers/hidden/layer4{
	dir = 1
	},
/obj/machinery/door/firedoor/border_only,
/obj/machinery/door/firedoor/border_only{
	dir = 1
	},
/obj/effect/turf_decal/corner/opaque/brown/half{
	dir = 1
	},
/turf/open/floor/plasteel/dark,
/area/ship/cargo)
"ZX" = (
/obj/structure/table/wood,
/obj/item/storage/box/donkpockets/donkpocketberry{
	pixel_y = 4
	},
/obj/item/storage/box/donkpockets{
	pixel_x = -2;
	pixel_y = 7
	},
/obj/machinery/airalarm/directional/east,
/obj/machinery/light/directional/south,
/obj/effect/turf_decal/corner/opaque/blue/three_quarters,
/turf/open/floor/plasteel/dark,
/area/ship/bridge)

(1,1,1) = {"
AF
Fp
So
Fp
So
OQ
So
Fp
So
Fp
AF
"}
(2,1,1) = {"
Fp
Fp
jG
Fp
jG
wr
jG
Fp
jG
Fp
Fp
"}
(3,1,1) = {"
Fp
hK
AX
nu
fh
hn
FE
KN
ON
Ku
Fp
"}
(4,1,1) = {"
Fp
Qy
aW
lz
PH
ss
Qv
TE
Rk
aS
Fp
"}
(5,1,1) = {"
Fp
Fp
Fp
Fp
Fp
fv
Fp
Fp
Fp
Fp
Fp
"}
(6,1,1) = {"
AF
CK
Ey
HI
Nv
AB
xc
Wo
Pu
xc
AF
"}
(7,1,1) = {"
AF
Ta
Qg
zn
Nv
AB
xc
xc
UO
xc
AF
"}
(8,1,1) = {"
AF
oV
Vi
FK
ZA
cA
vj
da
WT
Ze
AF
"}
(9,1,1) = {"
AF
Nm
FQ
mc
Nv
AB
qS
Op
OF
Ze
AF
"}
(10,1,1) = {"
AF
CK
uU
iN
Nv
AB
qS
Op
iZ
xc
AF
"}
(11,1,1) = {"
AF
xc
xc
xc
xc
KR
xc
rb
IL
xc
AF
"}
(12,1,1) = {"
AF
xc
CA
OV
ho
dj
qS
ue
OF
QD
AF
"}
(13,1,1) = {"
AF
QD
MF
Td
Cf
Sy
sQ
hd
OF
QD
AF
"}
(14,1,1) = {"
AF
QD
iq
Rw
FZ
kI
Nr
hd
EV
QD
AF
"}
(15,1,1) = {"
AF
xc
Mu
Rw
rE
kb
dX
og
Lc
xc
AF
"}
(16,1,1) = {"
AF
Fi
Fi
Jb
Hd
Hd
Hd
Lm
Fi
Fi
AF
"}
(17,1,1) = {"
AF
Fi
Ih
uA
bQ
Fd
oa
CM
yG
Fi
AF
"}
(18,1,1) = {"
AF
Fi
Fi
JD
RC
th
KD
ZX
Fi
Fi
AF
"}
(19,1,1) = {"
AF
AF
Fi
Fi
yq
yq
sq
Fi
Fi
AF
AF
"}
(20,1,1) = {"
AF
AF
AF
AF
AF
AF
AF
AF
AF
AF
AF
"}
