//MAP CONVERTED BY dmm2tgm.py THIS HEADER COMMENT PREVENTS RECONVERSION, DO NOT REMOVE
"bd" = (
/obj/structure/crate_shelf,
/obj/effect/decal/cleanable/dirt/dust,
/turf/open/floor/plasteel,
/area/ship/bridge)
"cl" = (
/obj/structure/grille,
/obj/effect/spawner/structure/window/reinforced,
/obj/machinery/door/poddoor{
	name = "Blast Door";
	dir = 4
	},
/turf/open/floor/plasteel/dark,
/area/ship/bridge)
"dB" = (
/obj/machinery/computer/helm{
	dir = 8
	},
/obj/effect/decal/cleanable/dirt/dust,
/turf/open/floor/plasteel/dark,
/area/ship/bridge)
"dJ" = (
/obj/machinery/light/directional/west,
/obj/structure/tank_dispenser/oxygen,
/obj/effect/decal/cleanable/dirt/dust,
/obj/structure/window/reinforced/spawner{
	dir = 1
	},
/obj/effect/turf_decal/industrial/hatch/yellow,
/turf/open/floor/plasteel/dark,
/area/ship/bridge)
"fC" = (
/obj/structure/cable{
	icon_state = "1-4"
	},
/obj/structure/cable{
	icon_state = "2-4"
	},
/obj/effect/decal/cleanable/dirt,
/turf/open/floor/plasteel,
/area/ship/bridge)
"fY" = (
/obj/machinery/door/firedoor,
/obj/effect/decal/cleanable/dirt,
/turf/open/floor/mineral/plastitanium,
/area/ship/bridge)
"hw" = (
/turf/template_noop,
/area/template_noop)
"hO" = (
/obj/machinery/power/terminal{
	dir = 8
	},
/obj/structure/cable,
/obj/item/storage/toolbox/mechanical,
/obj/item/storage/toolbox/electrical,
/obj/item/storage/firstaid/advanced,
/obj/item/storage/firstaid/medical,
/obj/item/storage/belt/utility/full,
/obj/machinery/autolathe,
/obj/effect/decal/cleanable/dirt/dust,
/obj/item/clothing/gloves/color/yellow,
/obj/item/flashlight,
/obj/item/extinguisher,
/obj/item/clothing/head/welding,
/obj/item/stack/sheet/glass/five,
/obj/item/stack/sheet/metal/five,
/obj/structure/closet/wall/directional/south{
	name = "Tools"
	},
/turf/open/floor/plasteel,
/area/ship/bridge)
"jd" = (
/obj/item/kirbyplants/random,
/obj/effect/decal/cleanable/dirt/dust,
/obj/machinery/firealarm/directional/west,
/turf/open/floor/plasteel,
/area/ship/bridge)
"je" = (
/obj/machinery/microwave,
/obj/structure/table,
/obj/effect/decal/cleanable/cobweb/cobweb2,
/obj/effect/decal/cleanable/dirt/dust,
/turf/open/floor/plasteel/dark,
/area/ship/bridge)
"kC" = (
/obj/item/kirbyplants/random,
/obj/effect/decal/cleanable/dirt/dust,
/obj/machinery/light_switch{
	dir = 4;
	pixel_x = -23
	},
/turf/open/floor/plasteel,
/area/ship/bridge)
"lk" = (
/obj/machinery/power/smes/shuttle/precharged{
	dir = 4
	},
/obj/structure/window/reinforced/spawner{
	dir = 8
	},
/obj/structure/cable{
	icon_state = "0-8"
	},
/obj/effect/decal/cleanable/dirt/dust,
/turf/open/floor/plating,
/area/ship/bridge)
"ll" = (
/turf/open/floor/plasteel,
/area/ship/bridge)
"ma" = (
/obj/effect/decal/cleanable/dirt/dust,
/turf/open/floor/plasteel,
/area/ship/bridge)
"oR" = (
/obj/effect/decal/cleanable/cobweb,
/obj/effect/decal/cleanable/dirt/dust,
/obj/structure/closet,
/obj/item/spacecash/bundle/c1000,
/obj/item/spacecash/bundle/c1000,
/mob/living/simple_animal/pet/mothroach,
/obj/machinery/newscaster/directional/north,
/turf/open/floor/plasteel/dark,
/area/ship/bridge)
"pn" = (
/obj/machinery/power/smes/engineering,
/obj/effect/decal/cleanable/sprayweb,
/obj/machinery/power/apc/auto_name/directional/west,
/obj/structure/cable{
	icon_state = "0-6"
	},
/obj/effect/decal/cleanable/dirt/dust,
/turf/open/floor/plating,
/area/ship/bridge)
"pz" = (
/turf/closed/wall/r_wall,
/area/ship/bridge)
"qR" = (
/obj/effect/decal/cleanable/greenglow{
	color = "#808080"
	},
/obj/machinery/cryopod{
	dir = 4
	},
/obj/machinery/computer/cryopod/directional/west,
/obj/effect/decal/cleanable/cobweb,
/obj/structure/window/reinforced/spawner{
	dir = 1
	},
/turf/open/floor/plasteel/freezer,
/area/ship/bridge)
"ry" = (
/obj/structure/closet/crate/trashcart,
/obj/effect/decal/cleanable/dirt/dust,
/obj/effect/spawner/lootdrop/waste/trash,
/obj/effect/spawner/lootdrop/waste/trash,
/obj/effect/spawner/lootdrop/waste/trash,
/turf/open/floor/plasteel,
/area/ship/bridge)
"tK" = (
/obj/item/soap,
/obj/item/reagent_containers/spray/cleaner,
/obj/item/mop,
/obj/item/reagent_containers/glass/bucket,
/obj/machinery/shower{
	dir = 8
	},
/obj/structure/curtain,
/obj/machinery/door/window{
	dir = 8
	},
/obj/structure/window/reinforced/spawner{
	dir = 1
	},
/obj/structure/closet/wall/directional/south{
	name = "Cleaning tools"
	},
/turf/open/floor/plasteel/freezer,
/area/ship/bridge)
"ut" = (
/obj/machinery/computer/cargo{
	dir = 8
	},
/obj/effect/decal/cleanable/dirt/dust,
/turf/open/floor/plasteel/dark,
/area/ship/bridge)
"vw" = (
/obj/machinery/light/directional/east,
/obj/structure/cable/yellow{
	icon_state = "1-8"
	},
/obj/structure/cable{
	icon_state = "9-10"
	},
/turf/open/floor/plating,
/area/ship/bridge)
"wd" = (
/obj/machinery/door/firedoor,
/obj/item/radio/intercom/wideband/directional/south,
/turf/open/floor/mineral/plastitanium,
/area/ship/bridge)
"xO" = (
/obj/structure/cable/yellow{
	icon_state = "0-2"
	},
/obj/machinery/power/port_gen/pacman,
/obj/item/stack/sheet/mineral/plasma/fifty,
/obj/effect/decal/cleanable/dirt/dust,
/obj/machinery/airalarm/directional/east,
/turf/open/floor/plating,
/area/ship/bridge)
"zu" = (
/obj/machinery/light/directional/west,
/obj/structure/window/reinforced/spawner{
	dir = 1
	},
/turf/open/floor/plasteel,
/area/ship/bridge)
"BG" = (
/obj/effect/decal/cleanable/dirt/dust,
/obj/item/storage/bag/ore,
/obj/structure/rack,
/obj/item/shovel,
/obj/item/pickaxe/drill,
/turf/open/floor/plasteel,
/area/ship/bridge)
"CA" = (
/obj/machinery/light/directional/east,
/obj/machinery/door/window/brigdoor/northright,
/turf/open/floor/plasteel,
/area/ship/bridge)
"FY" = (
/obj/machinery/power/shuttle/engine/electric{
	dir = 4
	},
/obj/structure/cable{
	icon_state = "0-4"
	},
/turf/open/floor/plating,
/area/ship/bridge)
"Gr" = (
/obj/effect/decal/cleanable/dirt,
/turf/open/floor/plasteel,
/area/ship/bridge)
"Gt" = (
/obj/item/storage/cans/sixbeer,
/obj/item/storage/box/donkpockets,
/obj/item/storage/box/donkpockets/donkpocketpizza,
/obj/effect/decal/cleanable/dirt/dust,
/obj/structure/table,
/obj/item/reagent_containers/food/snacks/chips,
/obj/item/reagent_containers/food/snacks/chips,
/obj/item/reagent_containers/food/snacks/chips,
/obj/item/reagent_containers/food/snacks/chips,
/obj/item/reagent_containers/food/snacks/chips,
/obj/structure/closet/wall/directional/north,
/turf/open/floor/plasteel/dark,
/area/ship/bridge)
"Hy" = (
/obj/machinery/holopad/emergency,
/turf/open/floor/plasteel/dark,
/area/ship/bridge)
"HH" = (
/obj/machinery/light/directional/west,
/turf/open/floor/plasteel/dark,
/area/ship/bridge)
"Jb" = (
/obj/structure/fans/tiny,
/obj/effect/decal/cleanable/dirt,
/obj/machinery/door/firedoor,
/obj/machinery/door/airlock/external{
	dir = 4
	},
/turf/open/floor/plating,
/area/ship/bridge)
"Ou" = (
/obj/structure/cable{
	icon_state = "1-2"
	},
/turf/open/floor/plasteel,
/area/ship/bridge)
"OZ" = (
/turf/open/floor/plasteel/dark,
/area/ship/bridge)
"Rc" = (
/obj/structure/chair/comfy/shuttle{
	dir = 4;
	name = "Helm"
	},
/turf/open/floor/plasteel/dark,
/area/ship/bridge)
"So" = (
/obj/structure/cable{
	icon_state = "5-8"
	},
/turf/open/floor/plasteel,
/area/ship/bridge)
"SC" = (
/obj/item/trash/chips,
/mob/living/simple_animal/hostile/cockroach,
/turf/open/floor/plasteel/dark,
/area/ship/bridge)
"Ta" = (
/obj/docking_port/stationary{
	dwidth = 15;
	height = 15;
	width = 30;
	dir = 8
	},
/turf/template_noop,
/area/template_noop)
"TU" = (
/obj/machinery/power/terminal{
	dir = 8
	},
/obj/structure/cable{
	icon_state = "0-2"
	},
/obj/effect/decal/cleanable/cobweb/cobweb2,
/obj/machinery/power/ship_gravity,
/turf/open/floor/plasteel,
/area/ship/bridge)
"UL" = (
/obj/structure/sink{
	dir = 1;
	pixel_y = -10
	},
/obj/structure/mirror{
	pixel_y = -30
	},
/obj/machinery/door/window/northright,
/turf/open/floor/plasteel/freezer,
/area/ship/bridge)
"VL" = (
/obj/structure/cable{
	icon_state = "4-8"
	},
/obj/machinery/door/firedoor,
/turf/open/floor/mineral/plastitanium,
/area/ship/bridge)
"VO" = (
/obj/machinery/button/door{
	dir = 8;
	id = 1;
	name = "Blast Door Control";
	pixel_x = 25;
	pixel_y = 5
	},
/obj/structure/table,
/obj/effect/decal/cleanable/dirt/dust,
/obj/item/gps{
	pixel_y = 5;
	pixel_x = 5
	},
/obj/item/pen/survival,
/obj/machinery/light_switch{
	dir = 8;
	pixel_x = 24;
	pixel_y = -4
	},
/turf/open/floor/plasteel/dark,
/area/ship/bridge)
"VY" = (
/obj/machinery/suit_storage_unit/standard_unit,
/obj/effect/decal/cleanable/dirt/dust,
/obj/machinery/firealarm/directional/east,
/obj/structure/window/reinforced/spawner{
	dir = 1
	},
/obj/effect/turf_decal/industrial/hatch/yellow,
/turf/open/floor/plasteel/dark,
/area/ship/bridge)
"Wp" = (
/obj/machinery/light/directional/west,
/obj/effect/decal/cleanable/cobweb,
/obj/structure/cable/yellow{
	icon_state = "0-4"
	},
/obj/machinery/power/terminal{
	dir = 1
	},
/obj/structure/railing,
/turf/open/floor/plating,
/area/ship/bridge)
"WS" = (
/obj/machinery/door/firedoor,
/obj/machinery/newscaster/directional/north,
/turf/open/floor/mineral/plastitanium,
/area/ship/bridge)
"YD" = (
/obj/structure/cable{
	icon_state = "1-2"
	},
/obj/machinery/light/directional/east,
/turf/open/floor/plasteel,
/area/ship/bridge)
"Zv" = (
/obj/structure/fans/tiny,
/obj/machinery/door/firedoor,
/obj/machinery/door/airlock/external{
	dir = 4
	},
/turf/open/floor/plating,
/area/ship/bridge)
"ZI" = (
/obj/structure/grille,
/obj/effect/spawner/structure/window/reinforced,
/obj/machinery/door/poddoor{
	name = "Blast Door";
	dir = 4
	},
/obj/docking_port/mobile{
	dir = 4;
	launch_status = 0;
	preferred_direction = 4;
	port_direction = 2
	},
/turf/open/floor/plasteel/dark,
/area/ship/bridge)

(1,1,1) = {"
pz
hw
pz
hw
Ta
pz
hw
pz
"}
(2,1,1) = {"
pz
FY
pz
Zv
Jb
pz
FY
pz
"}
(3,1,1) = {"
pz
lk
kC
ma
Gr
jd
lk
pz
"}
(4,1,1) = {"
pz
TU
YD
fC
Ou
YD
hO
pz
"}
(5,1,1) = {"
pz
pz
pz
VL
fY
pz
pz
pz
"}
(6,1,1) = {"
pz
pn
Wp
So
ry
zu
BG
pz
"}
(7,1,1) = {"
pz
xO
vw
ll
ll
CA
bd
pz
"}
(8,1,1) = {"
pz
pz
pz
WS
wd
pz
pz
pz
"}
(9,1,1) = {"
pz
oR
HH
OZ
OZ
dJ
qR
pz
"}
(10,1,1) = {"
pz
Gt
SC
Rc
Hy
OZ
UL
pz
"}
(11,1,1) = {"
pz
je
VO
dB
ut
VY
tK
pz
"}
(12,1,1) = {"
pz
pz
pz
ZI
cl
pz
pz
pz
"}
(13,1,1) = {"
pz
hw
hw
hw
hw
hw
hw
pz
"}
