//MAP CONVERTED BY dmm2tgm.py THIS HEADER COMMENT PREVENTS RECONVERSION, DO NOT REMOVE
"bl" = (
/obj/machinery/computer/telecomms/monitor{
	network = "all_broadcast"
	},
/obj/structure/window/bronze{
	dir = 4
	},
/obj/structure/window/bronze{
	dir = 1
	},
/turf/open/floor/plasteel/telecomms_floor,
/area/ship/maintenance/central)
"bn" = (
/obj/machinery/door/window{
	dir = 4
	},
/turf/open/floor/plasteel/telecomms_floor,
/area/ship/maintenance/central)
"cp" = (
/obj/structure/closet/wall/blue/directional/north,
/obj/structure/table/bronze,
/obj/item/megaphone/command,
/obj/item/binoculars,
/obj/item/gun/ballistic/automatic/pistol/commissar,
/obj/item/ammo_box/c9mm,
/obj/item/ammo_box/magazine/co9mm,
/obj/item/ammo_box/magazine/co9mm,
/obj/item/storage/firstaid/medical,
/obj/item/clothing/suit/armor/vest/capcarapace/duster,
/obj/item/ammo_box/magazine/co9mm/inc,
/obj/structure/window/reinforced/tinted/frosted{
	dir = 8;
	pixel_x = -4
	},
/obj/item/clothing/under/syndicate,
/obj/machinery/atmospherics/components/unary/vent_scrubber/on/layer4,
/obj/item/clothing/head/beret/captain,
/turf/open/floor/carpet/nanoweave/blue,
/area/ship/bridge)
"cs" = (
/obj/effect/spawner/structure/window/shuttle,
/obj/machinery/door/poddoor/shutters{
	dir = 4;
	id = 34563
	},
/turf/open/floor/plating,
/area/ship/bridge)
"dl" = (
/obj/effect/decal/cleanable/food/flour,
/turf/open/floor/carpet/nanoweave/beige,
/area/ship/maintenance/central)
"dN" = (
/obj/machinery/atmospherics/pipe/manifold/supply/hidden/layer2,
/obj/structure/cable{
	icon_state = "4-8"
	},
/obj/machinery/atmospherics/pipe/manifold/scrubbers/hidden/layer4,
/turf/open/floor/carpet/nanoweave/red,
/area/ship/maintenance/central)
"fx" = (
/turf/open/floor/plasteel/telecomms_floor,
/area/ship/maintenance/central)
"fO" = (
/obj/machinery/computer/helm{
	icon_state = "computer-middle";
	dir = 8;
	pixel_x = 7
	},
/obj/structure/cable{
	icon_state = "1-8"
	},
/mob/living/simple_animal/parrot/Polly{
	name = "Carl";
	desc = "Carl the Parrot. The most annoying creature in the universe."
	},
/turf/open/floor/carpet/nanoweave/blue,
/area/ship/bridge)
"fQ" = (
/obj/structure/cable{
	icon_state = "2-4"
	},
/obj/effect/decal/cleanable/plasma,
/turf/open/floor/carpet/nanoweave/red,
/area/ship/maintenance/central)
"ho" = (
/turf/open/floor/carpet/nanoweave,
/area/ship/maintenance/central)
"hV" = (
/obj/structure/window/bronze{
	dir = 8
	},
/obj/structure/closet/crate/engineering{
	name = "relay crate"
	},
/obj/item/circuitboard/machine/telecomms/relay,
/obj/item/circuitboard/machine/telecomms/relay,
/obj/item/circuitboard/machine/telecomms/relay,
/obj/item/circuitboard/machine/telecomms/relay,
/obj/item/circuitboard/machine/telecomms/relay,
/obj/item/stock_parts/subspace/filter,
/obj/item/stock_parts/subspace/filter,
/obj/item/stock_parts/subspace/filter,
/obj/item/stock_parts/subspace/filter,
/obj/item/stock_parts/subspace/filter,
/obj/item/stock_parts/subspace/filter,
/obj/item/stock_parts/subspace/filter,
/obj/item/stock_parts/subspace/filter,
/obj/item/stock_parts/subspace/filter,
/obj/item/stock_parts/subspace/filter,
/obj/item/stock_parts/manipulator,
/obj/item/stock_parts/manipulator,
/obj/item/stock_parts/manipulator,
/obj/item/stock_parts/manipulator,
/obj/item/stock_parts/manipulator,
/obj/item/stock_parts/manipulator,
/obj/item/stock_parts/manipulator,
/obj/item/stock_parts/manipulator,
/obj/item/stock_parts/manipulator,
/obj/item/stock_parts/manipulator,
/obj/item/storage/part_replacer,
/obj/item/stack/sheet/metal/five,
/obj/item/stack/sheet/metal/twenty,
/obj/item/stack/cable_coil/random,
/turf/open/floor/plasteel/telecomms_floor,
/area/ship/maintenance/central)
"hX" = (
/obj/machinery/button/door{
	id = "lock_dockp";
	pixel_y = 25;
	pixel_x = -8;
	specialfunctions = 4;
	normaldoorcontrol = 1
	},
/obj/structure/closet/secure_closet/freezer,
/obj/item/reagent_containers/food/snacks/meat/slab/monkey,
/obj/item/reagent_containers/food/snacks/meat/slab/monkey,
/obj/item/reagent_containers/food/snacks/meat/slab/monkey,
/obj/item/reagent_containers/food/snacks/meat/slab/monkey,
/obj/item/reagent_containers/food/snacks/meat/slab/monkey,
/obj/item/reagent_containers/food/snacks/meat/slab/monkey,
/obj/item/reagent_containers/condiment/milk,
/obj/item/reagent_containers/condiment/milk,
/obj/item/reagent_containers/condiment/soymilk,
/obj/item/reagent_containers/condiment/soymilk,
/obj/item/reagent_containers/condiment/enzyme,
/obj/structure/extinguisher_cabinet/directional/north{
	pixel_x = 9
	},
/obj/machinery/light/directional/east,
/obj/machinery/light_switch{
	pixel_y = 24
	},
/obj/item/storage/fancy/egg_box,
/obj/item/storage/fancy/egg_box,
/obj/item/storage/box/ingredients/fruity,
/obj/item/storage/box/ingredients/carnivore,
/obj/item/storage/box/ingredients/delights,
/obj/item/reagent_containers/condiment/flour,
/obj/item/reagent_containers/condiment/flour,
/obj/item/reagent_containers/condiment/rice,
/obj/item/reagent_containers/condiment/rice,
/obj/item/reagent_containers/condiment/mayonnaise,
/obj/item/reagent_containers/condiment/ketchup,
/obj/item/storage/box/ingredients/vegetarian,
/obj/item/storage/box/ingredients/wildcard,
/turf/open/floor/carpet/nanoweave/beige,
/area/ship/maintenance/central)
"iE" = (
/obj/machinery/light/small/directional/south{
	pixel_x = -15
	},
/obj/machinery/airalarm/directional/south,
/obj/machinery/computer/secure_data{
	icon_state = "computer-right";
	dir = 8;
	pixel_x = 7
	},
/turf/open/floor/carpet/nanoweave/blue,
/area/ship/bridge)
"iM" = (
/obj/machinery/power/apc/auto_name/directional/west,
/obj/structure/cable{
	icon_state = "0-4"
	},
/obj/machinery/portable_atmospherics/canister/air,
/obj/machinery/atmospherics/components/unary/portables_connector/layer2{
	dir = 4
	},
/obj/machinery/light_switch{
	pixel_y = 12;
	pixel_x = -20;
	dir = 4
	},
/obj/item/clothing/head/helmet/space/eva,
/obj/item/clothing/head/helmet/space/eva,
/obj/item/clothing/suit/space/eva,
/obj/item/clothing/suit/space/eva,
/obj/structure/closet/emcloset/wall/directional/west{
	pixel_x = -34;
	name = "Emergency space suits"
	},
/obj/item/clothing/suit/space/eva,
/obj/item/clothing/head/helmet/space/eva,
/obj/item/tank/internals/emergency_oxygen,
/obj/item/clothing/mask/breath,
/obj/item/tank/internals/oxygen,
/obj/item/tank/internals/oxygen,
/obj/item/tank/internals/oxygen,
/turf/open/floor/plasteel,
/area/ship/maintenance/central)
"jA" = (
/obj/structure/cable{
	icon_state = "1-2"
	},
/obj/structure/cable{
	icon_state = "0-8"
	},
/obj/machinery/power/terminal{
	icon_state = "term";
	dir = 8
	},
/obj/machinery/power/port_gen/pacman{
	anchored = 1
	},
/obj/effect/decal/cleanable/plasma,
/obj/item/stack/sheet/mineral/plasma/twenty,
/turf/open/floor/plasteel,
/area/ship/maintenance/central)
"jC" = (
/obj/structure/table/bronze,
/obj/item/paper_bin{
	pixel_x = 6;
	pixel_y = 1
	},
/obj/item/pen/fourcolor{
	pixel_x = 6
	},
/obj/item/stamp/captain{
	pixel_x = -9;
	pixel_y = 11
	},
/obj/item/stamp/denied{
	pixel_x = -8;
	pixel_y = 5
	},
/obj/item/stamp{
	pixel_x = -7;
	pixel_y = -1
	},
/obj/item/melee/knife/letter_opener{
	pixel_x = 28;
	pixel_y = 6
	},
/obj/machinery/newscaster/directional/south,
/turf/open/floor/carpet/nanoweave/orange,
/area/ship/crew/office)
"kv" = (
/obj/structure/cable{
	icon_state = "1-2"
	},
/obj/machinery/door/window/westright{
	dir = 2
	},
/turf/open/floor/carpet/nanoweave,
/area/ship/crew/cryo)
"ld" = (
/obj/item/paper/crumpled{
	default_raw_text = "Б/У машинерия, возможно нужна повторная настройка"
	},
/obj/item/multitool{
	pixel_x = -10;
	name = "telecomms debug tool"
	},
/turf/open/floor/plasteel/telecomms_floor,
/area/ship/maintenance/central)
"ml" = (
/obj/machinery/telecomms/hub{
	network = "all_broadcast"
	},
/turf/open/floor/plasteel/telecomms_floor,
/area/ship/maintenance/central)
"nd" = (
/obj/structure/cable{
	icon_state = "1-2"
	},
/obj/structure/cable{
	icon_state = "1-8"
	},
/obj/machinery/atmospherics/pipe/simple/scrubbers/hidden/layer4{
	icon_state = "pipe11-4";
	dir = 5
	},
/obj/machinery/atmospherics/pipe/simple/supply/hidden/layer2{
	dir = 5
	},
/obj/effect/decal/cleanable/plasma,
/obj/structure/cable{
	icon_state = "2-4";
	tag = null
	},
/obj/item/stock_parts/capacitor/super{
	pixel_y = -13;
	pixel_x = -8
	},
/obj/item/stock_parts/micro_laser/ultra{
	pixel_y = -11;
	pixel_x = 7
	},
/obj/item/paper/crumpled{
	default_raw_text = "новые запчасти для пакмэна, на установку не было времени"
	},
/turf/open/floor/carpet/nanoweave/red,
/area/ship/maintenance/central)
"np" = (
/obj/machinery/holopad/emergency/command,
/obj/structure/cable{
	icon_state = "4-8"
	},
/obj/machinery/atmospherics/pipe/simple/scrubbers/hidden/layer4{
	dir = 4
	},
/obj/machinery/atmospherics/pipe/simple/supply/hidden/layer2{
	dir = 4
	},
/turf/open/floor/carpet/nanoweave/blue,
/area/ship/bridge)
"nM" = (
/obj/structure/table/bronze,
/obj/item/reagent_containers/condiment/saltshaker{
	pixel_y = 8;
	pixel_x = 9
	},
/obj/item/reagent_containers/condiment/peppermill{
	pixel_x = 9
	},
/obj/item/melee/knife/kitchen{
	pixel_x = 4
	},
/obj/item/cutting_board{
	pixel_x = -1;
	pixel_y = 3
	},
/obj/structure/window/reinforced/tinted/frosted{
	dir = 4;
	pixel_x = 6
	},
/turf/open/floor/carpet/nanoweave/beige,
/area/ship/maintenance/central)
"pa" = (
/turf/closed/wall/mineral/titanium/nodiagonal,
/area/ship/crew/cryo)
"pf" = (
/obj/machinery/atmospherics/pipe/simple/supply/hidden/layer2{
	dir = 4
	},
/obj/structure/cable{
	icon_state = "4-8"
	},
/obj/machinery/atmospherics/pipe/simple/scrubbers/hidden/layer4{
	dir = 4
	},
/turf/open/floor/carpet/nanoweave/red,
/area/ship/maintenance/central)
"qK" = (
/turf/template_noop,
/area/template_noop)
"qQ" = (
/obj/machinery/cryopod{
	dir = 8
	},
/obj/machinery/power/apc/auto_name/directional/north,
/obj/machinery/light_switch{
	pixel_y = 23;
	pixel_x = 11
	},
/obj/structure/window/reinforced/tinted/frosted{
	pixel_y = -2
	},
/obj/machinery/computer/cryopod/directional/east,
/obj/structure/cable{
	icon_state = "0-8"
	},
/turf/open/floor/carpet/nanoweave,
/area/ship/crew/cryo)
"rM" = (
/obj/machinery/telecomms/broadcaster{
	network = "all_broadcast"
	},
/obj/structure/window/bronze{
	dir = 1
	},
/turf/open/floor/plasteel/telecomms_floor,
/area/ship/maintenance/central)
"rQ" = (
/obj/structure/chair/sofa/brown/left{
	dir = 4
	},
/obj/item/toy/plush/lizardplushie{
	pixel_y = -8;
	pixel_x = 2
	},
/obj/machinery/atmospherics/components/unary/vent_pump/on/layer2,
/turf/open/floor/carpet/nanoweave,
/area/ship/maintenance/central)
"si" = (
/obj/machinery/button/door{
	id = "lock_airl";
	pixel_y = 7;
	pixel_x = -25;
	specialfunctions = 4;
	normaldoorcontrol = 1;
	dir = 4
	},
/obj/machinery/power/smes/engineering,
/obj/structure/cable{
	icon_state = "0-1"
	},
/turf/open/floor/plasteel,
/area/ship/maintenance/central)
"tO" = (
/obj/structure/cable{
	icon_state = "1-2"
	},
/obj/structure/cable{
	icon_state = "2-8"
	},
/obj/machinery/atmospherics/pipe/simple/scrubbers/hidden/layer4,
/obj/machinery/atmospherics/pipe/simple/supply/hidden/layer2{
	icon_state = "pipe11-2";
	dir = 10
	},
/obj/machinery/power/ship_gravity,
/obj/structure/cable{
	d2 = 2;
	icon_state = "0-2";
	pixel_y = 1
	},
/turf/open/floor/plasteel,
/area/ship/maintenance/central)
"vB" = (
/obj/machinery/power/shuttle/engine/electric/tech1{
	dir = 4
	},
/obj/structure/cable{
	icon_state = "0-4"
	},
/turf/open/floor/plating,
/area/ship/maintenance/central)
"vM" = (
/obj/machinery/power/apc/auto_name/directional/south,
/obj/structure/cable,
/obj/machinery/light_switch{
	pixel_y = -16;
	pixel_x = -12;
	dir = 1
	},
/obj/item/gun/ballistic/revolver/detective,
/obj/item/clothing/accessory/holster/detective{
	pixel_y = 5
	},
/obj/item/camera/detective,
/obj/item/ammo_box/c38/dumdum,
/obj/item/ammo_box/c38/iceblox,
/obj/structure/closet/wall/directional/south{
	pixel_y = -32
	},
/obj/item/clothing/suit/det_suit,
/obj/item/clothing/head/fedora/det_hat,
/turf/open/floor/carpet/nanoweave/orange,
/area/ship/crew/office)
"xF" = (
/obj/machinery/atmospherics/pipe/simple/scrubbers/hidden/layer4{
	icon_state = "pipe11-4";
	dir = 10
	},
/turf/closed/wall/mineral/titanium/nodiagonal,
/area/ship/maintenance/central)
"xV" = (
/obj/machinery/atmospherics/components/unary/passive_vent/layer4,
/obj/effect/turf_decal/industrial/warning/fulltile,
/obj/item/toy/plush/narplush,
/turf/open/floor/plating,
/area/ship/maintenance/central)
"yT" = (
/obj/machinery/light/directional/east{
	pixel_y = -3
	},
/obj/machinery/computer/telecomms/server{
	dir = 1
	},
/turf/open/floor/plasteel/telecomms_floor,
/area/ship/maintenance/central)
"zh" = (
/obj/machinery/door/window/westright,
/obj/machinery/atmospherics/pipe/simple/scrubbers/hidden/layer4{
	dir = 4
	},
/obj/structure/cable{
	icon_state = "4-8"
	},
/obj/structure/cable{
	icon_state = "2-8"
	},
/obj/machinery/atmospherics/pipe/simple/supply/hidden/layer2{
	dir = 4
	},
/turf/open/floor/carpet/nanoweave/blue,
/area/ship/bridge)
"zk" = (
/obj/structure/cable{
	icon_state = "4-8"
	},
/obj/structure/cable{
	icon_state = "1-8"
	},
/obj/machinery/atmospherics/pipe/simple/scrubbers/hidden/layer4{
	dir = 4
	},
/obj/machinery/atmospherics/pipe/simple/supply/hidden/layer2{
	dir = 4
	},
/turf/open/floor/carpet/nanoweave/blue,
/area/ship/bridge)
"Ap" = (
/obj/structure/bed,
/obj/item/bedsheet/dorms,
/obj/structure/curtain/cloth/grey,
/obj/machinery/light/small/directional/north,
/obj/item/reagent_containers/food/drinks/bottle/rum{
	pixel_y = -5;
	pixel_x = -3
	},
/turf/open/floor/carpet/nanoweave,
/area/ship/crew/cryo)
"Cd" = (
/obj/structure/fans/tiny,
/obj/machinery/door/airlock/external/glass{
	dir = 8;
	id_tag = "lock_airl";
	glass = 0
	},
/turf/open/floor/plating,
/area/ship/maintenance/central)
"Dn" = (
/obj/structure/closet/wall/directional/north{
	pixel_y = 32
	},
/obj/structure/cable{
	icon_state = "2-4";
	tag = null
	},
/obj/item/tank/internals/emergency_oxygen/double,
/obj/item/tank/internals/emergency_oxygen/double,
/obj/item/flashlight/seclite,
/obj/item/flashlight/seclite,
/obj/item/flashlight/seclite,
/obj/item/tank/internals/emergency_oxygen/double,
/obj/item/clothing/under/suit/beige,
/obj/item/clothing/under/suit/black,
/obj/item/clothing/under/color/black,
/obj/item/clothing/head/beret/black,
/obj/item/clothing/mask/whistle,
/obj/item/clothing/glasses/sunglasses,
/obj/item/clothing/glasses/sunglasses,
/obj/item/clothing/glasses/sunglasses,
/turf/open/floor/carpet/nanoweave,
/area/ship/crew/cryo)
"Ec" = (
/obj/machinery/telecomms/server{
	network = "all_broadcast"
	},
/turf/open/floor/plasteel/telecomms_floor,
/area/ship/maintenance/central)
"Gk" = (
/obj/machinery/door/airlock/external/glass{
	id_tag = "lock_dockp";
	glass = 0
	},
/obj/structure/fans/tiny,
/obj/docking_port/mobile{
	dir = 2;
	port_direction = 8;
	preferred_direction = 4
	},
/turf/open/floor/plating,
/area/ship/maintenance/central)
"Go" = (
/obj/structure/curtain/cloth/grey,
/obj/item/bedsheet/dorms,
/obj/structure/bed,
/obj/structure/window/reinforced/tinted/frosted,
/turf/open/floor/carpet/nanoweave,
/area/ship/crew/cryo)
"Ht" = (
/obj/machinery/atmospherics/pipe/simple/scrubbers/hidden/layer4{
	dir = 4
	},
/obj/machinery/atmospherics/pipe/simple/supply/hidden/layer2{
	dir = 4
	},
/obj/structure/cable{
	icon_state = "4-8"
	},
/turf/open/floor/carpet/nanoweave/red,
/area/ship/maintenance/central)
"HJ" = (
/obj/structure/chair/sofa/brown/right{
	dir = 4
	},
/obj/machinery/atmospherics/components/unary/vent_scrubber/on/layer4,
/obj/machinery/atmospherics/pipe/simple/supply/hidden/layer2,
/turf/open/floor/carpet/nanoweave,
/area/ship/maintenance/central)
"HL" = (
/obj/machinery/door/window/westright{
	dir = 1
	},
/obj/structure/cable{
	icon_state = "1-2"
	},
/turf/open/floor/carpet/nanoweave/orange,
/area/ship/crew/office)
"Kc" = (
/obj/structure/chair/comfy/shuttle/bronze{
	dir = 4
	},
/obj/structure/cable{
	icon_state = "4-8"
	},
/obj/machinery/atmospherics/pipe/simple/scrubbers/hidden/layer4{
	dir = 9
	},
/obj/machinery/atmospherics/pipe/simple/supply/hidden/layer2{
	icon_state = "pipe11-2";
	dir = 10
	},
/turf/open/floor/carpet/nanoweave/blue,
/area/ship/bridge)
"KY" = (
/obj/machinery/computer/cargo{
	icon_state = "computer-left";
	dir = 8;
	pixel_x = 7
	},
/obj/machinery/light/small/directional/north{
	pixel_x = -15
	},
/obj/machinery/power/apc/auto_name/directional/north,
/obj/structure/cable{
	d2 = 2;
	icon_state = "0-2";
	pixel_y = 1
	},
/obj/machinery/light_switch{
	pixel_y = 23;
	pixel_x = 11
	},
/turf/open/floor/carpet/nanoweave/blue,
/area/ship/bridge)
"Lj" = (
/turf/closed/wall/mineral/titanium/nodiagonal,
/area/ship/bridge)
"Mm" = (
/obj/structure/window/bronze{
	dir = 1
	},
/obj/structure/chair/comfy/shuttle/bronze,
/turf/open/floor/carpet/nanoweave/orange,
/area/ship/crew/office)
"My" = (
/obj/effect/decal/cleanable/vomit,
/turf/open/floor/carpet/nanoweave/beige,
/area/ship/maintenance/central)
"MP" = (
/obj/structure/cable{
	icon_state = "0-8"
	},
/obj/machinery/power/smes/shuttle/precharged{
	dir = 4
	},
/obj/structure/window/plasma/reinforced/spawner/west,
/obj/machinery/door/poddoor/shutters{
	dir = 4;
	id = 34563
	},
/turf/open/floor/plasteel,
/area/ship/maintenance/central)
"Nv" = (
/obj/machinery/shower{
	icon_state = "shower";
	dir = 8;
	pixel_x = -6;
	pixel_y = -3
	},
/obj/machinery/door/window/westright,
/obj/item/soap/deluxe{
	pixel_x = -1;
	pixel_y = -6
	},
/obj/structure/window/reinforced/tinted/frosted,
/obj/item/towel,
/turf/open/floor/plasteel/white,
/area/ship/crew/cryo)
"NH" = (
/turf/closed/wall/mineral/titanium/nodiagonal,
/area/ship/maintenance/central)
"Of" = (
/obj/structure/table/bronze,
/obj/item/lighter/clockwork{
	pixel_y = -4
	},
/obj/item/storage/fancy/cigarettes/cigpack_syndicate{
	pixel_x = 10;
	pixel_y = 4
	},
/obj/machinery/light/directional/south,
/obj/item/toy/figure/detective{
	pixel_x = -12;
	pixel_y = 2
	},
/turf/open/floor/carpet/nanoweave/orange,
/area/ship/crew/office)
"Pi" = (
/obj/machinery/telecomms/receiver{
	network = "all_broadcast"
	},
/obj/structure/window/bronze{
	dir = 1
	},
/turf/open/floor/plasteel/telecomms_floor,
/area/ship/maintenance/central)
"QV" = (
/obj/structure/window/bronze{
	dir = 4
	},
/obj/structure/window/bronze{
	dir = 1
	},
/obj/structure/table/bronze,
/obj/machinery/fax,
/turf/open/floor/carpet/nanoweave/orange,
/area/ship/crew/office)
"Su" = (
/obj/item/radio/intercom/wideband/directional/south,
/obj/structure/table/bronze,
/obj/machinery/button/door{
	id = 34563;
	name = "Окна";
	pixel_y = -5;
	pixel_x = -8
	},
/obj/item/reagent_containers/food/drinks/coffee{
	pixel_x = 7;
	pixel_y = -2
	},
/obj/machinery/jukebox/boombox{
	pixel_x = -2;
	pixel_y = 1
	},
/obj/machinery/atmospherics/components/unary/vent_pump/on/layer2{
	dir = 1
	},
/turf/open/floor/carpet/nanoweave/blue,
/area/ship/bridge)
"SP" = (
/obj/structure/closet/wall/orange/directional/west{
	pixel_y = 7;
	pixel_x = -29
	},
/obj/item/clothing/gloves/color/yellow,
/obj/item/clothing/glasses/welding,
/obj/item/stack/sheet/glass/twenty,
/obj/item/pickaxe/mini,
/obj/item/clothing/glasses/meson/engine,
/obj/item/stack/sheet/metal/fifty,
/obj/item/clothing/gloves/color/latex/engineering,
/obj/item/clothing/suit/hooded/enginseer{
	armor = list("melee" = 50, "bullet" = 40, "laser" = 50, "energy" = 50, "bomb" = 25, "bio" = 0, "rad" = 0, "fire" = 100, "acid" = 90)
	},
/obj/machinery/vending/wallmed{
	pixel_y = 32
	},
/obj/machinery/light/small/directional/north{
	pixel_x = -10
	},
/obj/item/vending_refill/clothing,
/obj/item/vending_refill/cigarette,
/obj/item/clothing/head/beret/atmos,
/obj/item/circuitboard/machine/vendor,
/obj/item/circuitboard/machine/vendor,
/obj/item/clothing/suit/space/engineer,
/obj/item/clothing/head/helmet/space/light/engineer,
/obj/item/reagent_containers/glass/bottle/welding_fuel,
/obj/item/reagent_containers/glass/bottle/welding_fuel,
/obj/item/storage/belt/utility/full/engi,
/turf/open/floor/carpet/nanoweave,
/area/ship/maintenance/central)
"Vb" = (
/obj/structure/table/bronze,
/turf/open/floor/carpet/nanoweave/beige,
/area/ship/maintenance/central)
"VV" = (
/obj/effect/spawner/structure/window/shuttle,
/obj/machinery/door/poddoor/shutters{
	id = 34563
	},
/turf/open/floor/plating,
/area/ship/maintenance/central)
"Wj" = (
/obj/structure/table/bronze,
/obj/machinery/microwave,
/obj/structure/window/reinforced/tinted/frosted{
	dir = 4;
	pixel_x = 5
	},
/turf/open/floor/carpet/nanoweave/beige,
/area/ship/maintenance/central)
"WO" = (
/turf/closed/wall/mineral/titanium/nodiagonal,
/area/ship/crew/office)
"Xr" = (
/obj/structure/cable{
	icon_state = "0-4"
	},
/obj/machinery/power/shuttle/engine/electric/tech1{
	dir = 4
	},
/turf/open/floor/plating,
/area/ship/maintenance/central)
"YN" = (
/obj/machinery/power/terminal{
	icon_state = "term";
	dir = 8
	},
/obj/structure/cable{
	icon_state = "0-1"
	},
/obj/structure/closet/crate/secure/loot,
/obj/item/clothing/head/bronze,
/obj/item/clothing/shoes/bronze,
/obj/item/clothing/suit/bronze,
/obj/item/toy/plush/plushvar,
/obj/item/melee/spear,
/obj/machinery/light/directional/south,
/turf/open/floor/plasteel,
/area/ship/maintenance/central)
"YP" = (
/obj/machinery/power/terminal{
	icon_state = "term";
	dir = 8
	},
/obj/structure/cable{
	icon_state = "0-2"
	},
/obj/machinery/atmospherics/pipe/simple/scrubbers/hidden/layer4,
/obj/machinery/airalarm/directional/north,
/obj/machinery/autolathe,
/turf/open/floor/plasteel,
/area/ship/maintenance/central)
"Zu" = (
/obj/machinery/atmospherics/pipe/simple/scrubbers/hidden/layer4{
	icon_state = "pipe11-4";
	dir = 5
	},
/turf/closed/wall/mineral/titanium/nodiagonal,
/area/ship/maintenance/central)
"ZS" = (
/obj/machinery/telecomms/bus{
	network = "all_broadcast"
	},
/obj/structure/window/bronze{
	dir = 8
	},
/obj/structure/window/bronze{
	dir = 1
	},
/turf/open/floor/plasteel/telecomms_floor,
/area/ship/maintenance/central)
"ZU" = (
/obj/machinery/telecomms/processor{
	network = "all_broadcast"
	},
/turf/open/floor/plasteel/telecomms_floor,
/area/ship/maintenance/central)

(1,1,1) = {"
qK
NH
vB
NH
Cd
NH
Xr
NH
qK
"}
(2,1,1) = {"
xV
Zu
MP
iM
fQ
si
MP
NH
qK
"}
(3,1,1) = {"
NH
xF
YP
tO
nd
jA
YN
NH
NH
"}
(4,1,1) = {"
NH
SP
rQ
HJ
dN
ZS
hV
ZU
VV
"}
(5,1,1) = {"
VV
ho
ho
ho
pf
rM
fx
Ec
VV
"}
(6,1,1) = {"
Gk
My
dl
Vb
Ht
Pi
ld
ml
VV
"}
(7,1,1) = {"
NH
hX
nM
Wj
Ht
bl
bn
yT
VV
"}
(8,1,1) = {"
pa
pa
Ap
Go
zh
HL
vM
WO
WO
"}
(9,1,1) = {"
qK
pa
Dn
kv
zk
Mm
jC
WO
qK
"}
(10,1,1) = {"
qK
pa
qQ
Nv
np
QV
Of
WO
qK
"}
(11,1,1) = {"
qK
Lj
Lj
cp
Kc
Su
Lj
Lj
qK
"}
(12,1,1) = {"
qK
qK
Lj
KY
fO
iE
Lj
qK
qK
"}
(13,1,1) = {"
qK
qK
Lj
cs
cs
cs
Lj
qK
qK
"}
