//MAP CONVERTED BY dmm2tgm.py THIS HEADER COMMENT PREVENTS RECONVERSION, DO NOT REMOVE
"ai" = (
/obj/structure/stone_tile/surrounding/burnt,
/obj/structure/stone_tile/center/burnt,
/turf/open/lava/plasma_gaint/lit,
/area/overmap_encounter/planetoid/plasma_gaint/explored)
"bc" = (
/obj/structure/stone_tile/block/burnt{
	dir = 4
	},
/turf/open/floor/plating/asteroid/basalt/plasma_gaint{
	light_range = 1
	},
/area/overmap_encounter/planetoid/plasma_gaint/explored)
"cp" = (
/obj/effect/gibspawner/human,
/obj/structure/stone_tile{
	dir = 4
	},
/turf/open/floor/plating/asteroid/plasma_gaint,
/area/overmap_encounter/planetoid/plasma_gaint/explored)
"cD" = (
/obj/structure/flora/rock/hell,
/turf/open/floor/plating/asteroid/basalt/plasma_gaint{
	light_range = 1
	},
/area/overmap_encounter/planetoid/plasma_gaint/explored)
"cR" = (
/obj/structure/stone_tile{
	dir = 4
	},
/obj/structure/stone_tile{
	dir = 8
	},
/obj/structure/stone_tile{
	dir = 1
	},
/turf/open/floor/plating/asteroid/basalt/plasma_gaint{
	light_range = 1
	},
/area/overmap_encounter/planetoid/plasma_gaint/explored)
"dg" = (
/obj/structure/stone_tile/block/cracked{
	dir = 1
	},
/turf/open/floor/plating/asteroid/plasma_gaint,
/area/overmap_encounter/planetoid/plasma_gaint/explored)
"ek" = (
/obj/structure/stone_tile{
	dir = 8
	},
/obj/structure/stone_tile{
	dir = 1
	},
/turf/open/floor/plating/asteroid/plasma_gaint,
/area/overmap_encounter/planetoid/plasma_gaint/explored)
"eP" = (
/obj/structure/stone_tile/center/burnt{
	fall_on_cross = 1;
	pixel_x = -1;
	pixel_y = -9
	},
/obj/structure/stone_tile/center/burnt{
	fall_on_cross = 1;
	pixel_x = 3;
	pixel_y = 7
	},
/turf/open/lava/plasma_gaint/lit,
/area/overmap_encounter/planetoid/plasma_gaint/explored)
"fi" = (
/obj/structure/stone_tile/slab/cracked,
/obj/effect/decal/cleanable/blood/tracks,
/turf/open/floor/plating/asteroid/plasma_gaint,
/area/overmap_encounter/planetoid/plasma_gaint/explored)
"go" = (
/obj/structure/stone_tile{
	dir = 8
	},
/obj/structure/stone_tile{
	dir = 4
	},
/obj/structure/stone_tile{
	dir = 1
	},
/obj/structure/stone_tile,
/turf/open/floor/plating/asteroid/basalt/plasma_gaint{
	light_range = 1
	},
/area/overmap_encounter/planetoid/plasma_gaint/explored)
"gD" = (
/obj/structure/stone_tile{
	dir = 4
	},
/obj/structure/stone_tile{
	dir = 8
	},
/obj/structure/stone_tile{
	dir = 1
	},
/obj/structure/stone_tile,
/turf/open/floor/plating/asteroid/basalt/plasma_gaint{
	light_range = 1
	},
/area/overmap_encounter/planetoid/plasma_gaint/explored)
"hy" = (
/obj/structure/stone_tile/block/burnt{
	dir = 1
	},
/turf/open/floor/plating/asteroid/plasma_gaint,
/area/overmap_encounter/planetoid/plasma_gaint/explored)
"hX" = (
/turf/open/floor/plating/asteroid/basalt/plasma_gaint{
	light_range = 1
	},
/area/overmap_encounter/planetoid/plasma_gaint/explored)
"iz" = (
/obj/structure/stone_tile/cracked{
	dir = 1
	},
/turf/open/floor/plating/asteroid/plasma_gaint,
/area/overmap_encounter/planetoid/plasma_gaint/explored)
"iY" = (
/obj/structure/stone_tile/surrounding/cracked,
/obj/effect/decal/cleanable/blood/tracks,
/turf/open/floor/plating/asteroid/basalt/plasma_gaint{
	light_range = 1
	},
/area/overmap_encounter/planetoid/plasma_gaint/explored)
"jl" = (
/obj/structure/stone_tile/center/burnt{
	fall_on_cross = 1;
	pixel_x = 5;
	pixel_y = 8
	},
/obj/structure/stone_tile/center/burnt{
	fall_on_cross = 1;
	pixel_x = -11;
	pixel_y = -11
	},
/turf/open/lava/plasma_gaint/lit,
/area/overmap_encounter/planetoid/plasma_gaint/explored)
"kg" = (
/obj/structure/stone_tile/slab/cracked{
	dir = 6
	},
/turf/open/floor/plating/asteroid/basalt/plasma_gaint{
	light_range = 1
	},
/area/overmap_encounter/planetoid/plasma_gaint/explored)
"kj" = (
/obj/structure/stone_tile/slab/cracked{
	dir = 5
	},
/obj/structure/barricade/wooden,
/turf/open/floor/plating/asteroid/basalt/plasma_gaint{
	light_range = 1
	},
/area/overmap_encounter/planetoid/plasma_gaint/explored)
"lg" = (
/obj/structure/stone_tile/surrounding,
/obj/structure/flora/ash/fireblossom{
	pixel_y = 11;
	pixel_x = 2
	},
/turf/open/floor/plating/asteroid/plasma_gaint,
/area/overmap_encounter/planetoid/plasma_gaint/explored)
"li" = (
/obj/structure/stone_tile/block/cracked{
	dir = 8
	},
/turf/open/floor/plating/asteroid/basalt/plasma_gaint{
	light_range = 1
	},
/area/overmap_encounter/planetoid/plasma_gaint/explored)
"lx" = (
/obj/item/pickaxe/rusted{
	pixel_x = 3
	},
/turf/open/floor/plating/asteroid/plasma_gaint,
/area/overmap_encounter/planetoid/plasma_gaint/explored)
"lA" = (
/obj/structure/barricade/wooden,
/turf/open/floor/plating/asteroid/basalt/plasma_gaint{
	light_range = 1
	},
/area/overmap_encounter/planetoid/plasma_gaint/explored)
"nZ" = (
/obj/structure/flora/rock/lava,
/turf/open/floor/plating/asteroid/basalt/plasma_gaint{
	light_range = 1
	},
/area/overmap_encounter/planetoid/plasma_gaint/explored)
"oa" = (
/obj/structure/stone_tile{
	dir = 1
	},
/turf/open/floor/plating/asteroid/plasma_gaint,
/area/overmap_encounter/planetoid/plasma_gaint/explored)
"oh" = (
/obj/structure/table/wood,
/obj/item/gun/ballistic/bow/ashen,
/obj/structure/stone_tile{
	dir = 4
	},
/turf/open/floor/plating/asteroid/basalt/plasma_gaint{
	light_range = 1
	},
/area/overmap_encounter/planetoid/plasma_gaint/explored)
"ox" = (
/obj/structure/stone_tile/block/cracked{
	dir = 1
	},
/obj/structure/stone_tile/block/cracked{
	dir = 9;
	pixel_x = -16;
	pixel_y = 16
	},
/turf/open/floor/plating/asteroid/basalt/plasma_gaint{
	light_range = 1
	},
/area/overmap_encounter/planetoid/plasma_gaint/explored)
"pg" = (
/obj/structure/stone_tile,
/obj/structure/stone_tile{
	dir = 1
	},
/obj/structure/stone_tile{
	dir = 8
	},
/obj/structure/stone_tile{
	dir = 4
	},
/turf/open/floor/plating/asteroid/plasma_gaint,
/area/overmap_encounter/planetoid/plasma_gaint/explored)
"pU" = (
/obj/structure/stone_tile{
	dir = 1
	},
/obj/structure/stone_tile{
	dir = 4
	},
/obj/structure/stone_tile{
	dir = 8
	},
/turf/open/floor/plating/asteroid/basalt/plasma_gaint{
	light_range = 1
	},
/area/overmap_encounter/planetoid/plasma_gaint/explored)
"qw" = (
/obj/structure/stone_tile/slab/cracked{
	dir = 6
	},
/obj/effect/decal/cleanable/blood/tracks,
/turf/open/floor/plating/asteroid/plasma_gaint,
/area/overmap_encounter/planetoid/plasma_gaint/explored)
"qI" = (
/obj/structure/destructible/tribal_torch/lit{
	pixel_y = 13
	},
/obj/structure/stone_tile/surrounding/cracked,
/obj/structure/stone_tile/center/burnt,
/turf/open/floor/plating/asteroid/basalt/plasma_gaint{
	light_range = 1
	},
/area/overmap_encounter/planetoid/plasma_gaint/explored)
"rt" = (
/obj/structure/stone_tile/block/cracked{
	dir = 2
	},
/turf/open/floor/plating/asteroid/basalt/plasma_gaint{
	light_range = 1
	},
/area/overmap_encounter/planetoid/plasma_gaint/explored)
"rX" = (
/obj/effect/decal/cleanable/blood/bubblegum,
/turf/open/floor/plating/asteroid/basalt/plasma_gaint{
	light_range = 1
	},
/area/overmap_encounter/planetoid/plasma_gaint/explored)
"sd" = (
/obj/structure/table/wood,
/obj/item/reagent_containers/glass/mortar/mushroom{
	pixel_x = -5
	},
/obj/item/reagent_containers/food/snacks/grown/ash_flora/mushroom_stem{
	pixel_x = -11;
	pixel_y = 10
	},
/obj/item/pestle{
	pixel_y = 5
	},
/turf/open/floor/plating/asteroid/plasma_gaint,
/area/overmap_encounter/planetoid/plasma_gaint/explored)
"sn" = (
/obj/structure/destructible/tribal_torch/lit{
	pixel_y = 13
	},
/obj/structure/stone_tile/surrounding,
/obj/structure/stone_tile/center/burnt,
/obj/structure/stone_tile/center/burnt,
/turf/open/floor/plating/asteroid/basalt/plasma_gaint{
	light_range = 1
	},
/area/overmap_encounter/planetoid/plasma_gaint/explored)
"sv" = (
/obj/structure/stone_tile/center/burnt{
	fall_on_cross = 1;
	pixel_x = -6;
	pixel_y = 2
	},
/obj/structure/stone_tile/center/burnt{
	fall_on_cross = 1;
	pixel_x = 10;
	pixel_y = 10
	},
/turf/open/lava/plasma_gaint/lit,
/area/overmap_encounter/planetoid/plasma_gaint/explored)
"sw" = (
/obj/structure/flora/rock/pile/rockplanet,
/turf/open/floor/plating/asteroid/basalt/plasma_gaint{
	light_range = 1
	},
/area/overmap_encounter/planetoid/plasma_gaint/explored)
"sT" = (
/obj/structure/stone_tile/block/burnt{
	dir = 1
	},
/obj/structure/stone_tile/cracked{
	dir = 8
	},
/turf/open/floor/plating/asteroid/basalt/plasma_gaint{
	light_range = 1
	},
/area/overmap_encounter/planetoid/plasma_gaint/explored)
"sZ" = (
/mob/living/simple_animal/hostile/megafauna/dragon/plasma{
	color = "#9370DB"
	},
/obj/structure/stone_tile/surrounding/cracked,
/turf/open/floor/plating/asteroid/plasma_gaint,
/area/overmap_encounter/planetoid/plasma_gaint/explored)
"tl" = (
/obj/structure/stone_tile/surrounding/cracked,
/turf/open/floor/plating/asteroid/basalt/plasma_gaint{
	light_range = 1
	},
/area/overmap_encounter/planetoid/plasma_gaint/explored)
"tO" = (
/obj/structure/stone_tile/slab/cracked{
	dir = 5
	},
/turf/open/floor/plating/asteroid/plasma_gaint,
/area/overmap_encounter/planetoid/plasma_gaint/explored)
"tR" = (
/obj/structure/stone_tile/slab/cracked{
	dir = 6
	},
/obj/effect/decal/cleanable/blood/tracks,
/turf/open/floor/plating/asteroid/basalt/plasma_gaint{
	light_range = 1
	},
/area/overmap_encounter/planetoid/plasma_gaint/explored)
"ub" = (
/turf/closed/mineral/random/plasma_gaint,
/area/overmap_encounter/planetoid/plasma_gaint/explored)
"vg" = (
/obj/structure/stone_tile/surrounding_tile{
	dir = 4
	},
/turf/open/floor/plating/asteroid/basalt/plasma_gaint{
	light_range = 1
	},
/area/overmap_encounter/planetoid/plasma_gaint/explored)
"vo" = (
/obj/structure/destructible/tribal_torch/lit{
	pixel_y = 13
	},
/obj/structure/stone_tile/center/burnt,
/obj/structure/stone_tile/surrounding/cracked{
	dir = 1
	},
/obj/structure/stone_tile/surrounding_tile{
	dir = 8
	},
/turf/open/floor/plating/asteroid/basalt/plasma_gaint{
	light_range = 1
	},
/area/overmap_encounter/planetoid/plasma_gaint/explored)
"vp" = (
/obj/structure/flora/ash/fern,
/turf/open/floor/plating/asteroid/basalt/plasma_gaint{
	light_range = 1
	},
/area/overmap_encounter/planetoid/plasma_gaint/explored)
"xW" = (
/obj/structure/stone_tile/surrounding/cracked{
	dir = 1
	},
/turf/open/floor/plating/asteroid/plasma_gaint,
/area/overmap_encounter/planetoid/plasma_gaint/explored)
"ye" = (
/obj/structure/stone_tile/block{
	dir = 1
	},
/turf/open/floor/plating/asteroid/basalt/plasma_gaint{
	light_range = 1
	},
/area/overmap_encounter/planetoid/plasma_gaint/explored)
"yf" = (
/obj/effect/decal/remains/human{
	pixel_y = 8
	},
/obj/effect/decal/cleanable/ash/large{
	pixel_y = -8
	},
/obj/item/clothing/suit/armor/curator,
/obj/item/clothing/head/fedora/curator{
	pixel_y = 16
	},
/obj/effect/decal/cleanable/blood/old,
/turf/open/floor/plating/asteroid/basalt/plasma_gaint{
	light_range = 1
	},
/area/overmap_encounter/planetoid/plasma_gaint/explored)
"yU" = (
/obj/structure/stone_tile/center/burnt{
	fall_on_cross = 1;
	pixel_x = 9;
	pixel_y = 2
	},
/obj/structure/stone_tile/center/burnt{
	fall_on_cross = 1;
	pixel_x = -7;
	pixel_y = -6
	},
/turf/open/lava/plasma_gaint/lit,
/area/overmap_encounter/planetoid/plasma_gaint/explored)
"zx" = (
/obj/effect/decal/cleanable/blood/tracks,
/turf/open/floor/plating/asteroid/plasma_gaint,
/area/overmap_encounter/planetoid/plasma_gaint/explored)
"zF" = (
/obj/structure/stone_tile/cracked{
	dir = 8
	},
/turf/open/floor/plating/asteroid/plasma_gaint,
/area/overmap_encounter/planetoid/plasma_gaint/explored)
"AR" = (
/obj/structure/stone_tile/surrounding/cracked,
/obj/structure/destructible/tribal_torch/lit{
	pixel_y = 13
	},
/obj/structure/stone_tile/center/burnt,
/turf/open/floor/plating/asteroid/plasma_gaint,
/area/overmap_encounter/planetoid/plasma_gaint/explored)
"AT" = (
/turf/template_noop,
/area/overmap_encounter/planetoid/plasma_gaint/explored)
"BZ" = (
/obj/structure/stone_tile/surrounding/cracked{
	dir = 4
	},
/turf/open/floor/plating/asteroid/basalt/plasma_gaint{
	light_range = 1
	},
/area/overmap_encounter/planetoid/plasma_gaint/explored)
"Cb" = (
/obj/structure/stone_tile,
/turf/open/floor/plating/asteroid/basalt/plasma_gaint{
	light_range = 1
	},
/area/overmap_encounter/planetoid/plasma_gaint/explored)
"Cu" = (
/obj/structure/stone_tile/surrounding/cracked{
	dir = 8
	},
/turf/open/floor/plating/asteroid/plasma_gaint,
/area/overmap_encounter/planetoid/plasma_gaint/explored)
"Dp" = (
/obj/structure/stone_tile/block/burnt,
/turf/open/floor/plating/asteroid/basalt/plasma_gaint{
	light_range = 1
	},
/area/overmap_encounter/planetoid/plasma_gaint/explored)
"Ee" = (
/obj/structure/stone_tile/slab,
/turf/open/floor/plating/asteroid/plasma_gaint,
/area/overmap_encounter/planetoid/plasma_gaint/explored)
"Ek" = (
/obj/structure/stone_tile/surrounding/cracked,
/turf/open/floor/plating/asteroid/plasma_gaint,
/area/overmap_encounter/planetoid/plasma_gaint/explored)
"EF" = (
/obj/structure/stone_tile/slab/cracked{
	dir = 4
	},
/turf/open/lava/plasma_gaint/lit,
/area/overmap_encounter/planetoid/plasma_gaint/explored)
"EI" = (
/obj/structure/destructible/tribal_torch/lit{
	pixel_y = 13
	},
/obj/structure/stone_tile/center/burnt,
/obj/structure/stone_tile/surrounding/cracked,
/turf/open/floor/plating/asteroid/plasma_gaint,
/area/overmap_encounter/planetoid/plasma_gaint/explored)
"FX" = (
/obj/structure/stone_tile{
	dir = 1
	},
/obj/structure/stone_tile,
/obj/structure/stone_tile{
	dir = 8
	},
/turf/open/floor/plating/asteroid/basalt/plasma_gaint{
	light_range = 1
	},
/area/overmap_encounter/planetoid/plasma_gaint/explored)
"Gm" = (
/obj/structure/stone_tile/cracked,
/turf/open/floor/plating/asteroid/plasma_gaint,
/area/overmap_encounter/planetoid/plasma_gaint/explored)
"Go" = (
/obj/structure/stone_tile{
	dir = 4
	},
/turf/open/floor/plating/asteroid/basalt/plasma_gaint{
	light_range = 1
	},
/area/overmap_encounter/planetoid/plasma_gaint/explored)
"GB" = (
/obj/structure/stone_tile/cracked{
	dir = 4
	},
/turf/open/floor/plating/asteroid/plasma_gaint,
/area/overmap_encounter/planetoid/plasma_gaint/explored)
"GT" = (
/obj/structure/stone_tile/cracked{
	dir = 8
	},
/turf/open/floor/plating/asteroid/basalt/plasma_gaint{
	light_range = 1
	},
/area/overmap_encounter/planetoid/plasma_gaint/explored)
"Hu" = (
/obj/structure/stone_tile/slab,
/turf/open/floor/plating/asteroid/basalt/plasma_gaint{
	light_range = 1
	},
/area/overmap_encounter/planetoid/plasma_gaint/explored)
"Ip" = (
/obj/structure/fluff/drake_statue/falling,
/turf/open/floor/plating/asteroid/basalt/plasma_gaint{
	light_range = 1
	},
/area/overmap_encounter/planetoid/plasma_gaint/explored)
"Ju" = (
/obj/structure/destructible/tribal_torch/lit{
	pixel_y = 13
	},
/obj/structure/stone_tile/center/burnt,
/obj/structure/stone_tile/surrounding/cracked{
	dir = 1
	},
/turf/open/floor/plating/asteroid/basalt/plasma_gaint{
	light_range = 1
	},
/area/overmap_encounter/planetoid/plasma_gaint/explored)
"JV" = (
/obj/structure/stone_tile{
	dir = 8
	},
/turf/open/floor/plating/asteroid/basalt/plasma_gaint{
	light_range = 1
	},
/area/overmap_encounter/planetoid/plasma_gaint/explored)
"JY" = (
/obj/structure/stone_tile/center/burnt{
	fall_on_cross = 1;
	pixel_x = -9;
	pixel_y = -10
	},
/turf/open/lava/plasma_gaint/lit,
/area/overmap_encounter/planetoid/plasma_gaint/explored)
"Kw" = (
/turf/template_noop,
/area/template_noop)
"KJ" = (
/turf/open/lava/plasma_gaint/lit,
/area/overmap_encounter/planetoid/plasma_gaint/explored)
"Lo" = (
/obj/structure/stone_tile/cracked{
	dir = 4
	},
/turf/open/floor/plating/asteroid/basalt/plasma_gaint{
	light_range = 1
	},
/area/overmap_encounter/planetoid/plasma_gaint/explored)
"LL" = (
/obj/structure/stone_tile/cracked{
	dir = 1
	},
/turf/open/floor/plating/asteroid/basalt/plasma_gaint{
	light_range = 1
	},
/area/overmap_encounter/planetoid/plasma_gaint/explored)
"Ms" = (
/obj/structure/stone_tile/slab/cracked,
/turf/open/floor/plating/asteroid/plasma_gaint,
/area/overmap_encounter/planetoid/plasma_gaint/explored)
"MD" = (
/obj/structure/stone_tile{
	dir = 4
	},
/obj/structure/stone_tile{
	dir = 1
	},
/obj/structure/stone_tile,
/turf/open/floor/plating/asteroid/basalt/plasma_gaint{
	light_range = 1
	},
/area/overmap_encounter/planetoid/plasma_gaint/explored)
"Nc" = (
/obj/structure/table/wood,
/obj/item/ammo_casing/caseless/arrow/bone{
	pixel_y = -4
	},
/obj/item/ammo_casing/caseless/arrow/bone{
	pixel_y = 4
	},
/obj/item/ammo_casing/caseless/arrow/bone{
	pixel_y = 8
	},
/obj/item/ammo_casing/caseless/arrow/bone{
	pixel_y = 12
	},
/obj/item/ammo_casing/caseless/arrow/bone,
/turf/open/floor/plating/asteroid/plasma_gaint,
/area/overmap_encounter/planetoid/plasma_gaint/explored)
"Nf" = (
/obj/effect/gibspawner/human,
/turf/open/floor/plating/asteroid/plasma_gaint,
/area/overmap_encounter/planetoid/plasma_gaint/explored)
"Nl" = (
/obj/effect/decal/remains/plasma,
/obj/effect/gibspawner/human,
/turf/open/floor/plating/asteroid/basalt/plasma_gaint{
	light_range = 1
	},
/area/overmap_encounter/planetoid/plasma_gaint/explored)
"ND" = (
/obj/structure/table_frame/wood,
/turf/open/floor/plating/asteroid/plasma_gaint,
/area/overmap_encounter/planetoid/plasma_gaint/explored)
"NM" = (
/obj/structure/stone_tile/block{
	dir = 8
	},
/turf/open/floor/plating/asteroid/basalt/plasma_gaint{
	light_range = 1
	},
/area/overmap_encounter/planetoid/plasma_gaint/explored)
"Ou" = (
/obj/structure/stone_tile/surrounding_tile{
	dir = 8
	},
/turf/open/floor/plating/asteroid/basalt/plasma_gaint{
	light_range = 1
	},
/area/overmap_encounter/planetoid/plasma_gaint/explored)
"OI" = (
/obj/structure/destructible/tribal_torch/lit{
	pixel_y = 13
	},
/obj/structure/stone_tile/surrounding,
/obj/structure/stone_tile/center/burnt,
/turf/open/floor/plating/asteroid/plasma_gaint,
/area/overmap_encounter/planetoid/plasma_gaint/explored)
"OP" = (
/obj/structure/stone_tile/slab/cracked{
	dir = 6
	},
/turf/open/floor/plating/asteroid/plasma_gaint,
/area/overmap_encounter/planetoid/plasma_gaint/explored)
"Pc" = (
/obj/structure/table/wood,
/turf/open/floor/plating/asteroid/basalt/plasma_gaint{
	light_range = 1
	},
/area/overmap_encounter/planetoid/plasma_gaint/explored)
"Ps" = (
/obj/structure/stone_tile/slab/cracked{
	dir = 1
	},
/turf/open/floor/plating/asteroid/plasma_gaint,
/area/overmap_encounter/planetoid/plasma_gaint/explored)
"PG" = (
/obj/structure/stone_tile,
/obj/structure/stone_tile{
	dir = 1
	},
/obj/structure/stone_tile/cracked{
	dir = 8
	},
/turf/open/floor/plating/asteroid/basalt/plasma_gaint{
	light_range = 1
	},
/area/overmap_encounter/planetoid/plasma_gaint/explored)
"PZ" = (
/obj/structure/stone_tile/cracked,
/turf/open/floor/plating/asteroid/basalt/plasma_gaint{
	light_range = 1
	},
/area/overmap_encounter/planetoid/plasma_gaint/explored)
"Qb" = (
/obj/structure/stone_tile{
	dir = 8
	},
/obj/structure/stone_tile{
	dir = 4
	},
/obj/structure/stone_tile,
/turf/open/floor/plating/asteroid/plasma_gaint,
/area/overmap_encounter/planetoid/plasma_gaint/explored)
"Qq" = (
/obj/structure/stone_tile/slab/cracked,
/turf/open/floor/plating/asteroid/basalt/plasma_gaint{
	light_range = 1
	},
/area/overmap_encounter/planetoid/plasma_gaint/explored)
"Qy" = (
/obj/structure/stone_tile/center/burnt{
	fall_on_cross = 1;
	pixel_x = -24;
	pixel_y = 5
	},
/turf/open/lava/plasma_gaint/lit,
/area/overmap_encounter/planetoid/plasma_gaint/explored)
"Rk" = (
/obj/structure/stone_tile{
	dir = 4
	},
/turf/open/floor/plating/asteroid/plasma_gaint,
/area/overmap_encounter/planetoid/plasma_gaint/explored)
"Rr" = (
/obj/structure/destructible/tribal_torch/lit{
	pixel_y = 13
	},
/obj/structure/stone_tile/surrounding,
/obj/structure/stone_tile/center/burnt,
/turf/open/floor/plating/asteroid/basalt/plasma_gaint{
	light_range = 1
	},
/area/overmap_encounter/planetoid/plasma_gaint/explored)
"Ru" = (
/obj/structure/fluff/drake_statue,
/turf/open/floor/plating/asteroid/basalt/plasma_gaint{
	light_range = 1
	},
/area/overmap_encounter/planetoid/plasma_gaint/explored)
"RH" = (
/obj/structure/table/wood,
/obj/item/reagent_containers/glass/bottle/potion{
	pixel_x = 10;
	pixel_y = 9
	},
/obj/item/reagent_containers/glass/bottle/potion,
/obj/item/reagent_containers/glass/bottle/potion{
	pixel_x = -10;
	pixel_y = 9
	},
/turf/open/floor/plating/asteroid/basalt/plasma_gaint{
	light_range = 1
	},
/area/overmap_encounter/planetoid/plasma_gaint/explored)
"RK" = (
/turf/open/floor/plating/asteroid/plasma_gaint,
/area/overmap_encounter/planetoid/plasma_gaint/explored)
"RU" = (
/turf/closed/indestructible/riveted/boss{
	max_integrity = 5e+007
	},
/area/overmap_encounter/planetoid/plasma_gaint/explored)
"Sm" = (
/obj/structure/flora/ausbushes/fullgrass/hell,
/turf/open/floor/plating/asteroid/basalt/plasma_gaint{
	light_range = 1
	},
/area/overmap_encounter/planetoid/plasma_gaint/explored)
"SS" = (
/obj/structure/stone_tile/surrounding/cracked{
	dir = 1
	},
/obj/structure/barricade/wooden,
/turf/open/floor/plating/asteroid/plasma_gaint,
/area/overmap_encounter/planetoid/plasma_gaint/explored)
"TT" = (
/obj/structure/stone_tile{
	dir = 4
	},
/obj/structure/stone_tile{
	dir = 8
	},
/obj/structure/stone_tile,
/turf/open/floor/plating/asteroid/basalt/plasma_gaint{
	light_range = 1
	},
/area/overmap_encounter/planetoid/plasma_gaint/explored)
"TU" = (
/obj/structure/stone_tile/slab/cracked{
	dir = 4
	},
/obj/structure/barricade/wooden/crude,
/turf/open/floor/plating/asteroid/basalt/plasma_gaint{
	light_range = 1
	},
/area/overmap_encounter/planetoid/plasma_gaint/explored)
"Ug" = (
/obj/structure/stone_tile{
	dir = 1
	},
/turf/open/floor/plating/asteroid/basalt/plasma_gaint{
	light_range = 1
	},
/area/overmap_encounter/planetoid/plasma_gaint/explored)
"Uj" = (
/obj/structure/stone_tile,
/obj/structure/stone_tile{
	dir = 1
	},
/obj/structure/stone_tile{
	dir = 4
	},
/obj/structure/stone_tile{
	dir = 8
	},
/turf/open/floor/plating/asteroid/plasma_gaint,
/area/overmap_encounter/planetoid/plasma_gaint/explored)
"Uw" = (
/obj/structure/stone_tile/surrounding/cracked{
	dir = 1
	},
/turf/open/floor/plating/asteroid/basalt/plasma_gaint{
	light_range = 1
	},
/area/overmap_encounter/planetoid/plasma_gaint/explored)
"UB" = (
/obj/structure/stone_tile/surrounding/cracked{
	dir = 4
	},
/turf/open/floor/plating/asteroid/plasma_gaint,
/area/overmap_encounter/planetoid/plasma_gaint/explored)
"XZ" = (
/obj/structure/barricade/wooden,
/turf/open/floor/plating/asteroid/plasma_gaint,
/area/overmap_encounter/planetoid/plasma_gaint/explored)
"YN" = (
/obj/structure/stone_tile/slab/cracked{
	dir = 1
	},
/turf/open/lava/plasma_gaint/lit,
/area/overmap_encounter/planetoid/plasma_gaint/explored)
"YR" = (
/obj/effect/decal/cleanable/blood/tracks,
/turf/open/floor/plating/asteroid/basalt/plasma_gaint{
	light_range = 1
	},
/area/overmap_encounter/planetoid/plasma_gaint/explored)
"Zh" = (
/obj/structure/stone_tile/block/burnt{
	dir = 4
	},
/turf/open/floor/plating/asteroid/plasma_gaint,
/area/overmap_encounter/planetoid/plasma_gaint/explored)
"Zo" = (
/obj/structure/stone_tile/surrounding/cracked,
/obj/effect/decal/cleanable/blood/tracks,
/turf/open/floor/plating/asteroid/plasma_gaint,
/area/overmap_encounter/planetoid/plasma_gaint/explored)
"ZD" = (
/obj/item/gem/amber,
/obj/structure/stone_tile/slab/burnt,
/turf/open/floor/plating/asteroid/basalt/plasma_gaint{
	light_range = 1
	},
/area/overmap_encounter/planetoid/plasma_gaint/explored)
"ZX" = (
/obj/structure/stone_tile/surrounding/cracked{
	dir = 8
	},
/obj/structure/destructible/tribal_torch/lit{
	pixel_y = 13
	},
/obj/structure/stone_tile/center/burnt,
/turf/open/floor/plating/asteroid/plasma_gaint,
/area/overmap_encounter/planetoid/plasma_gaint/explored)

(1,1,1) = {"
Kw
Kw
Kw
Kw
Kw
Kw
Kw
Kw
Kw
Kw
Kw
hX
Sm
Sm
hX
hX
hX
hX
hX
ub
ub
ub
hX
hX
vp
hX
Kw
Kw
Kw
Kw
Kw
Kw
Kw
Kw
Kw
Kw
Kw
Kw
"}
(2,1,1) = {"
Kw
Kw
Kw
Kw
Kw
Kw
Kw
Kw
Kw
Kw
Kw
hX
Sm
sw
vp
Sm
Sm
hX
ub
ub
ub
ub
hX
nZ
hX
hX
hX
hX
hX
AT
Kw
Kw
Kw
Kw
Kw
Kw
Kw
Kw
"}
(3,1,1) = {"
Kw
Kw
Kw
Kw
Kw
Kw
Kw
Kw
Kw
hX
hX
vp
hX
cD
hX
Sm
Sm
ub
ub
ub
ub
ub
hX
hX
hX
sw
hX
hX
hX
hX
hX
Kw
Kw
Kw
Kw
Kw
Kw
Kw
"}
(4,1,1) = {"
Kw
Kw
Kw
Kw
Kw
Kw
Kw
Kw
hX
Sm
hX
hX
nZ
Sm
Sm
Sm
hX
ub
ub
ub
ub
ub
ub
hX
hX
hX
Sm
Sm
hX
hX
hX
hX
Kw
Kw
Kw
Kw
Kw
Kw
"}
(5,1,1) = {"
Kw
Kw
Kw
Kw
Kw
Kw
hX
hX
hX
hX
Sm
Sm
Sm
hX
hX
sw
hX
ub
ub
ub
ub
ub
ub
hX
vp
hX
hX
Sm
hX
hX
vp
hX
Kw
Kw
Kw
Kw
Kw
Kw
"}
(6,1,1) = {"
Kw
Kw
Kw
Kw
Kw
hX
hX
vp
nZ
Sm
hX
vp
RU
RU
RU
RU
RU
ub
ub
ub
ub
ub
ub
hX
hX
hX
hX
hX
nZ
hX
hX
hX
hX
Kw
Kw
Kw
Kw
Kw
"}
(7,1,1) = {"
Kw
Kw
Kw
Kw
hX
hX
hX
Sm
hX
sw
hX
RU
RU
RK
RK
RK
RK
ub
ub
ub
ub
ub
RU
RU
hX
sw
cD
hX
hX
hX
hX
hX
hX
hX
Kw
Kw
Kw
Kw
"}
(8,1,1) = {"
Kw
Kw
Kw
hX
Sm
sw
Sm
Sm
Sm
hX
RU
RU
RK
Lo
Nf
zF
hX
ub
ub
ub
ub
ub
hX
RU
RU
hX
hX
vp
Sm
Sm
Sm
hX
hX
hX
Kw
Kw
Kw
Kw
"}
(9,1,1) = {"
Kw
Kw
hX
Sm
Sm
Sm
hX
hX
hX
RU
RU
UB
hX
hX
Rr
RK
RK
hX
RK
ub
ub
ub
hX
hX
RU
RU
RU
hX
hX
hX
hX
hX
hX
hX
hX
Kw
Kw
Kw
"}
(10,1,1) = {"
Kw
Kw
hX
Sm
hX
hX
cD
vp
RU
RU
hX
RK
RK
iz
UB
Gm
RK
RK
hX
RK
Rr
hX
hX
hX
hX
hX
RU
hX
hX
Sm
cD
hX
hX
nZ
hX
Kw
Kw
Kw
"}
(11,1,1) = {"
Kw
hX
hX
Sm
hX
hX
hX
hX
RU
hX
OI
RK
RK
Lo
li
JV
RK
RK
RK
hX
UB
hX
hX
hX
hX
hX
RU
hX
hX
Sm
hX
sw
hX
hX
hX
hX
Kw
Kw
"}
(12,1,1) = {"
Kw
hX
vp
Sm
hX
hX
hX
RU
RU
RK
GB
li
li
cR
KJ
Dp
Ee
Qq
Ee
RK
RK
RK
hX
hX
hX
hX
RU
RU
hX
hX
vp
hX
hX
Sm
hX
hX
hX
Kw
"}
(13,1,1) = {"
Kw
hX
hX
hX
hX
sw
RU
RU
RK
RK
hy
KJ
yU
KJ
JY
TT
zF
hX
RK
RK
Ee
Ms
RK
RK
hX
Rr
hX
RU
RU
RU
hX
hX
vp
Sm
hX
hX
hX
Kw
"}
(14,1,1) = {"
Kw
hX
Sm
Sm
hX
hX
RU
RK
Ee
Nf
dg
eP
ZD
jl
Qy
KJ
rt
hX
hX
RK
UB
RK
RK
RK
RK
hX
hX
hX
hX
RU
RU
hX
hX
Sm
cD
hX
hX
hX
"}
(15,1,1) = {"
Kw
Sm
Sm
hX
hX
RU
RU
ub
GB
hX
sT
KJ
sv
KJ
PG
bc
Gm
hX
tl
Hu
RK
RK
hX
Ee
pg
RK
hX
Nl
hX
hX
RU
RU
hX
hX
Sm
hX
hX
hX
"}
(16,1,1) = {"
Kw
Sm
hX
sw
vp
RU
ub
ub
hX
Qq
LL
ox
KJ
ub
Dp
hX
RK
hX
FX
hX
hX
hX
Ee
RK
Ps
RK
OP
RK
hX
hX
hX
RU
hX
hX
Sm
Sm
hX
hX
"}
(17,1,1) = {"
Kw
Sm
hX
hX
hX
RU
ub
ub
LL
hX
PZ
LL
Zh
Zh
Cb
hX
hX
kg
hX
Qq
hX
Nl
hX
Qq
RK
RK
RK
RK
RK
Rr
hX
RU
Ru
hX
hX
Sm
vp
hX
"}
(18,1,1) = {"
Kw
Sm
hX
cD
hX
RU
hX
hX
BZ
Qq
hX
RK
OP
RK
RK
hX
rX
hX
Hu
hX
qI
hX
tO
RK
Ee
OP
RK
Hu
Uw
Ms
tl
lA
hX
hX
sw
hX
nZ
hX
"}
(19,1,1) = {"
hX
hX
hX
Sm
hX
RU
hX
sn
hX
Hu
RK
hX
hX
Ee
ZX
OP
Ee
RK
Ms
OP
gD
hX
Ek
RK
OP
Ee
xW
RK
hX
Ps
RK
TU
hX
Sm
Sm
hX
hX
hX
"}
(20,1,1) = {"
hX
hX
sw
Sm
hX
RU
hX
hX
hX
hX
Ms
hX
hX
hX
lg
hX
hX
RK
hX
RK
RK
Lo
Ee
zF
RK
Ps
RK
hX
vg
Ms
Ee
SS
kg
hX
Sm
Sm
hX
hX
"}
(21,1,1) = {"
hX
hX
hX
Sm
hX
RU
hX
Qq
Pc
yf
RK
Hu
hX
kg
RK
hX
hX
sZ
YR
iY
tR
Zo
qw
zx
fi
zx
hX
go
hX
hX
Cu
XZ
hX
hX
hX
Sm
hX
hX
"}
(22,1,1) = {"
hX
hX
hX
hX
Sm
RU
RK
RK
sd
lx
RK
BZ
hX
hX
OP
tl
Ee
hX
hX
hX
hX
iz
OP
Gm
RK
Cu
kg
hX
kg
hX
RK
kj
hX
hX
cD
Sm
hX
Kw
"}
(23,1,1) = {"
hX
vp
hX
hX
Sm
RU
RU
hX
RH
RK
RK
GB
hX
zF
RK
hX
RK
hX
rX
Hu
kg
hX
RK
RK
RK
kg
Hu
hX
hX
Rr
hX
RU
Ip
vp
hX
Sm
hX
Kw
"}
(24,1,1) = {"
hX
hX
hX
hX
hX
hX
RU
hX
MD
Qq
RK
hX
Ee
RK
hX
tl
RK
tl
hX
hX
RK
hX
Qq
RK
RK
Ou
Uw
kg
hX
hX
hX
RU
hX
hX
Sm
Sm
hX
Kw
"}
(25,1,1) = {"
hX
sw
nZ
Sm
hX
hX
RU
hX
hX
Ju
RK
LL
Qq
PZ
hX
kg
OP
Lo
hX
GT
RK
Ek
hX
Uw
LL
Hu
hX
Qq
hX
hX
RU
RU
hX
hX
hX
hX
hX
Kw
"}
(26,1,1) = {"
hX
hX
hX
Sm
vp
hX
RU
RU
hX
hX
Uj
hX
Hu
hX
Nl
Hu
AR
hX
Hu
xW
RK
Ee
Cu
pU
hX
hX
hX
hX
hX
RU
RU
hX
Sm
Sm
hX
hX
hX
Kw
"}
(27,1,1) = {"
hX
hX
hX
Sm
RK
RK
hX
RU
hX
hX
hX
RK
BZ
hX
hX
hX
RK
LL
RK
PZ
OP
RK
Ek
hX
hX
vo
hX
RU
RU
RU
hX
hX
hX
Sm
hX
vp
hX
Kw
"}
(28,1,1) = {"
hX
hX
hX
Sm
sw
hX
RK
RU
RU
hX
hX
RK
RK
hX
hX
Qq
hX
RK
RK
RK
RK
hX
Ee
Uw
hX
hX
RU
RU
hX
vp
hX
sw
hX
Sm
Sm
cD
hX
Kw
"}
(29,1,1) = {"
hX
hX
vp
Sm
hX
hX
hX
hX
RU
hX
hX
hX
hX
Qq
hX
Hu
hX
Qb
RK
RK
RK
RK
RK
hX
Nl
hX
RU
hX
hX
hX
hX
hX
hX
Sm
nZ
hX
hX
Kw
"}
(30,1,1) = {"
Kw
hX
hX
hX
cD
sw
hX
hX
RU
RU
hX
hX
hX
RK
RK
RK
xW
Ms
xW
RK
Rr
hX
Qq
hX
hX
hX
RU
hX
nZ
Sm
hX
cD
hX
hX
hX
hX
Kw
Kw
"}
(31,1,1) = {"
Kw
hX
hX
Sm
hX
hX
hX
hX
hX
RU
hX
hX
RK
EI
hX
hX
hX
RK
RK
RK
hX
hX
ub
hX
RU
RU
RU
hX
hX
hX
Sm
hX
hX
hX
hX
Kw
Kw
Kw
"}
(32,1,1) = {"
Kw
hX
hX
Sm
Sm
hX
hX
hX
hX
RU
RK
hX
hX
oa
ek
RK
ND
RK
RK
ub
ub
ub
ub
RU
RU
hX
hX
hX
hX
hX
Sm
vp
hX
hX
Kw
Kw
Kw
Kw
"}
(33,1,1) = {"
Kw
hX
hX
hX
hX
Sm
Sm
Sm
hX
RU
RU
RK
hX
Ug
Ug
hX
RK
Nc
oh
NM
ub
ub
RU
RU
hX
hX
Sm
Sm
Sm
Sm
Sm
hX
hX
Kw
Kw
Kw
Kw
Kw
"}
(34,1,1) = {"
Kw
Kw
hX
sw
hX
hX
vp
Sm
hX
hX
RU
RU
RU
hX
hX
RK
cp
Go
pU
EF
ub
ub
RU
hX
hX
vp
hX
Sm
hX
sw
Sm
hX
hX
Kw
Kw
Kw
Kw
Kw
"}
(35,1,1) = {"
Kw
Kw
hX
hX
hX
hX
hX
Sm
cD
hX
hX
RK
RU
RU
RU
Rk
Cb
ye
ai
YN
ub
RU
RU
hX
hX
sw
cD
Sm
Sm
hX
hX
hX
hX
Kw
Kw
Kw
Kw
Kw
"}
(36,1,1) = {"
Kw
Kw
Kw
hX
hX
hX
nZ
Sm
Sm
Sm
vp
hX
hX
hX
RU
RU
RU
RU
RU
RU
RU
RU
hX
sw
hX
hX
hX
hX
Sm
Sm
hX
hX
Kw
Kw
Kw
Kw
Kw
Kw
"}
(37,1,1) = {"
Kw
Kw
Kw
Kw
Kw
hX
hX
Sm
sw
Sm
sw
hX
Sm
Sm
hX
hX
hX
hX
vp
hX
hX
hX
Sm
Sm
Sm
Sm
hX
hX
hX
hX
Kw
Kw
Kw
Kw
Kw
Kw
Kw
Kw
"}
(38,1,1) = {"
Kw
Kw
Kw
Kw
Kw
Kw
hX
hX
hX
hX
hX
Sm
Sm
hX
cD
hX
hX
Sm
Sm
Sm
hX
hX
Sm
nZ
vp
hX
hX
Kw
Kw
Kw
Kw
Kw
Kw
Kw
Kw
Kw
Kw
Kw
"}
(39,1,1) = {"
Kw
Kw
Kw
Kw
Kw
Kw
Kw
Kw
Kw
hX
hX
Sm
hX
hX
hX
sw
hX
hX
cD
Sm
hX
hX
Sm
Sm
Sm
hX
hX
Kw
Kw
Kw
Kw
Kw
Kw
Kw
Kw
Kw
Kw
Kw
"}
(40,1,1) = {"
Kw
Kw
Kw
Kw
Kw
Kw
Kw
Kw
Kw
Kw
hX
hX
vp
hX
hX
hX
hX
hX
hX
Sm
hX
vp
hX
sw
hX
hX
Kw
Kw
Kw
Kw
Kw
Kw
Kw
Kw
Kw
Kw
Kw
Kw
"}
