//MAP CONVERTED BY dmm2tgm.py THIS HEADER COMMENT PREVENTS RECONVERSION, DO NOT REMOVE
"aj" = (
/turf/closed/wall/mineral/wood,
/area/overmap_encounter/planetoid/cave/explored)
"aE" = (
/obj/effect/decal/cleanable/blood/old,
/turf/open/floor/plating/asteroid/snow/under,
/area/overmap_encounter/planetoid/cave/explored)
"aL" = (
/obj/machinery/power/shuttle/engine/fueled/plasma{
	dir = 4
	},
/turf/open/floor/wood/walnut,
/area/overmap_encounter/planetoid/cave/explored)
"bw" = (
/obj/item/paper/crumpled/ruins/snowdin/dontdeadopeninside{
	default_raw_text = "If you're reading this: GET OUT! The Cold made Baron mad, he performed some kind of pact but it backfired, If you find my body, please bury it\tkeeping the rest of us on lockdown and I swear to god I keep hearing strange noises outside the walls at night. The gateway link has gone dead and without a supply of resources from Central, we're left\tfor dead here. We haven't heard anything back from the mining squad either, so I can only assume whatever the fuck they unearthed got them first before coming for us. I don't want to die here..."
	},
/obj/effect/decal/cleanable/blood/squirt,
/turf/open/floor/plating/asteroid/snow/under,
/area/overmap_encounter/planetoid/cave/explored)
"cg" = (
/obj/effect/decal/cleanable/blood/gibs/old,
/turf/open/floor/wood/walnut,
/area/overmap_encounter/planetoid/cave/explored)
"cm" = (
/obj/effect/decal/cleanable/dirt/dust,
/turf/open/floor/plating/asteroid/snow/icemoon,
/area/overmap_encounter/planetoid/cave/explored)
"co" = (
/turf/closed/wall/mineral/iron,
/area/overmap_encounter/planetoid/cave/explored)
"dI" = (
/obj/item/stack/ore/salvage/scrapmetal,
/turf/open/floor/plating/asteroid/snow/icemoon,
/area/overmap_encounter/planetoid/cave/explored)
"dQ" = (
/mob/living/simple_animal/hostile/cult_demon{
	name = "Daemonic servant"
	},
/turf/open/floor/plating/asteroid/snow/under,
/area/overmap_encounter/planetoid/cave/explored)
"fX" = (
/obj/machinery/door/airlock/wood/glass,
/obj/effect/mapping_helpers/airlock/abandoned,
/turf/open/floor/wood/walnut,
/area/overmap_encounter/planetoid/cave/explored)
"gV" = (
/obj/structure/fluff/iced_abductor,
/obj/item/clothing/mask/frog,
/turf/open/floor/plating/asteroid/snow/icemoon,
/area/overmap_encounter/planetoid/cave/explored)
"hl" = (
/obj/structure/grille/broken,
/obj/effect/decal/cleanable/glass{
	pixel_x = 11;
	pixel_y = 9
	},
/obj/effect/decal/cleanable/glass,
/turf/open/floor/wood/walnut,
/area/overmap_encounter/planetoid/cave/explored)
"hQ" = (
/obj/effect/decal/cleanable/blood/gibs/body,
/turf/open/floor/plating/asteroid/snow/under,
/area/overmap_encounter/planetoid/cave/explored)
"ia" = (
/obj/machinery/atmospherics/pipe/simple/brown{
	dir = 1
	},
/turf/open/floor/wood/walnut,
/area/overmap_encounter/planetoid/cave/explored)
"iM" = (
/obj/structure/mineral_door/wood,
/obj/structure/barricade/wooden,
/obj/structure/barricade/wooden/crude,
/obj/structure/barricade/wooden/snowed,
/turf/open/floor/plating/asteroid/snow/icemoon,
/area/overmap_encounter/planetoid/cave/explored)
"iR" = (
/obj/effect/decal/cleanable/blood/old,
/turf/open/floor/wood/walnut,
/area/overmap_encounter/planetoid/cave/explored)
"ji" = (
/turf/closed/wall/ice,
/area/overmap_encounter/planetoid/cave/explored)
"kx" = (
/obj/effect/decal/cleanable/blood/tracks,
/obj/effect/decal/cleanable/blood/gibs/down,
/turf/open/floor/plating/asteroid/snow/under,
/area/overmap_encounter/planetoid/cave/explored)
"kO" = (
/obj/structure/sign/poster/official/fruit_bowl,
/turf/closed/wall/mineral/wood,
/area/overmap_encounter/planetoid/cave/explored)
"ln" = (
/turf/open/floor/plating/asteroid/snow/icemoon,
/area/overmap_encounter/planetoid/cave/explored)
"ly" = (
/obj/item/trash/can/food,
/obj/item/trash/boritos,
/turf/open/floor/plating/asteroid/snow/icemoon,
/area/overmap_encounter/planetoid/cave/explored)
"nr" = (
/turf/open/floor/wood/walnut,
/area/overmap_encounter/planetoid/cave/explored)
"nP" = (
/obj/effect/decal/cleanable/glass{
	pixel_x = 11;
	pixel_y = 9
	},
/turf/open/floor/plating/asteroid/snow/under,
/area/overmap_encounter/planetoid/cave/explored)
"nV" = (
/obj/effect/decal/cleanable/blood/squirt,
/turf/closed/mineral/snowmountain/icemoon,
/area/overmap_encounter/planetoid/cave/explored)
"ov" = (
/obj/structure/table/wood/fancy/red_gold,
/obj/item/melee/energy/axe{
	active_force = 30;
	active_heat = 40;
	armour_penetration = 20
	},
/obj/item/clothing/suit/armor/riot/knight/greyscale,
/obj/item/clothing/head/helmet/knight/greyscale,
/turf/open/floor/wood/walnut,
/area/overmap_encounter/planetoid/cave/explored)
"pa" = (
/obj/structure/fans/tiny,
/obj/machinery/door/airlock/wood/glass,
/obj/effect/mapping_helpers/airlock/abandoned,
/turf/open/floor/wood/walnut,
/area/overmap_encounter/planetoid/cave/explored)
"rA" = (
/obj/machinery/conveyor_switch,
/obj/item/shard,
/turf/open/floor/wood/walnut,
/area/overmap_encounter/planetoid/cave/explored)
"rX" = (
/obj/effect/decal/cleanable/dirt/dust,
/obj/effect/decal/cleanable/dirt/dust,
/turf/closed/mineral/snowmountain/icemoon,
/area/overmap_encounter/planetoid/cave/explored)
"uI" = (
/obj/effect/decal/cleanable/glass{
	pixel_x = 11;
	pixel_y = 9
	},
/obj/effect/decal/cleanable/glass{
	pixel_x = 11;
	pixel_y = 9
	},
/obj/structure/grille/broken,
/obj/effect/decal/cleanable/dirt/dust,
/turf/open/floor/wood/walnut,
/area/overmap_encounter/planetoid/cave/explored)
"vp" = (
/obj/effect/decal/cleanable/blood/tracks{
	dir = 4
	},
/turf/open/floor/plating/asteroid/snow/under,
/area/overmap_encounter/planetoid/cave/explored)
"wa" = (
/obj/item/clothing/suit/armor/bone,
/turf/open/floor/wood/cold,
/area/overmap_encounter/planetoid/cave/explored)
"wk" = (
/obj/structure/rack,
/obj/item/storage/firstaid/brute,
/obj/item/storage/firstaid/fire,
/turf/open/floor/wood/walnut,
/area/overmap_encounter/planetoid/cave/explored)
"wH" = (
/obj/structure/railing/wood{
	dir = 1
	},
/turf/open/floor/plating/asteroid/snow/icemoon,
/area/overmap_encounter/planetoid/cave/explored)
"xc" = (
/obj/machinery/atmospherics/pipe/simple/brown{
	dir = 1
	},
/obj/effect/decal/cleanable/blood/old,
/turf/open/floor/wood/walnut,
/area/overmap_encounter/planetoid/cave/explored)
"xy" = (
/obj/effect/decal/cleanable/blood/gibs/body,
/turf/closed/mineral/snowmountain/icemoon,
/area/overmap_encounter/planetoid/cave/explored)
"xL" = (
/obj/structure/destructible/tribal_torch/lit,
/turf/closed/mineral/snowmountain/icemoon,
/area/space)
"yY" = (
/turf/closed/mineral/random/snow,
/area/overmap_encounter/planetoid/cave/explored)
"zg" = (
/obj/structure/chair/wood/wings{
	dir = 4
	},
/turf/open/floor/wood/walnut,
/area/overmap_encounter/planetoid/cave/explored)
"zk" = (
/obj/item/trash/sosjerky,
/obj/item/trash/sosjerky,
/obj/item/trash/raisins,
/turf/open/floor/plating/asteroid/snow/icemoon,
/area/overmap_encounter/planetoid/cave/explored)
"Ai" = (
/turf/open/floor/plating/asteroid/snow/under,
/area/overmap_encounter/planetoid/cave/explored)
"An" = (
/obj/effect/decal/cleanable/blood/splatter/over_window,
/turf/closed/mineral/snowmountain/icemoon,
/area/overmap_encounter/planetoid/cave/explored)
"Ao" = (
/obj/effect/decal/cleanable/blood/squirt,
/turf/open/floor/plating/asteroid/snow/icemoon,
/area/overmap_encounter/planetoid/cave/explored)
"Az" = (
/obj/item/clothing/head/bearpelt,
/turf/open/floor/wood/cold,
/area/overmap_encounter/planetoid/cave/explored)
"AK" = (
/obj/structure/chair/wood/wings{
	dir = 4
	},
/mob/living/simple_animal/hostile/cult_demon{
	name = "Kutscher"
	},
/obj/item/gun/ballistic/bow/ashen,
/obj/effect/decal/cleanable/dirt/dust,
/obj/effect/decal/cleanable/ash,
/turf/open/floor/wood/walnut,
/area/overmap_encounter/planetoid/cave/explored)
"Bk" = (
/mob/living/simple_animal/hostile/cult_demon{
	name = "Daemonic servant"
	},
/turf/open/floor/plating/asteroid/snow/icemoon,
/area/overmap_encounter/planetoid/cave/explored)
"Bl" = (
/turf/open/floor/plating/asteroid/snow/icemoon,
/area/space)
"CT" = (
/obj/machinery/conveyor_switch,
/obj/effect/decal/cleanable/glass,
/obj/effect/decal/cleanable/blood/old,
/turf/open/floor/wood/walnut,
/area/overmap_encounter/planetoid/cave/explored)
"Dg" = (
/obj/item/reagent_containers/food/snacks/meat/slab/human/mutant/skeleton,
/obj/item/trash/tray,
/obj/item/trash/can/food,
/turf/open/floor/plating/asteroid/snow/icemoon,
/area/overmap_encounter/planetoid/cave/explored)
"Dx" = (
/obj/item/reagent_containers/food/snacks/meat/slab/human/mutant/skeleton,
/obj/item/trash/raisins,
/obj/item/trash/boritos,
/turf/open/floor/plating/asteroid/snow/icemoon,
/area/overmap_encounter/planetoid/cave/explored)
"DR" = (
/obj/effect/decal/cleanable/dirt/dust,
/turf/open/floor/wood/walnut,
/area/overmap_encounter/planetoid/cave/explored)
"Ek" = (
/turf/closed/wall/rust,
/area/overmap_encounter/planetoid/cave/explored)
"Fc" = (
/obj/item/stack/ore/salvage/scrapmetal,
/obj/structure/railing/wood{
	dir = 1
	},
/turf/open/floor/plating/asteroid/snow/icemoon,
/area/overmap_encounter/planetoid/cave/explored)
"FK" = (
/obj/structure/bonfire/prelit,
/turf/open/floor/plating/asteroid/snow/icemoon,
/area/overmap_encounter/planetoid/cave/explored)
"FO" = (
/turf/template_noop,
/area/template_noop)
"Gn" = (
/obj/item/shard,
/obj/effect/decal/cleanable/glass{
	pixel_x = 11;
	pixel_y = 9
	},
/obj/effect/decal/cleanable/blood/old,
/turf/open/floor/wood/walnut,
/area/overmap_encounter/planetoid/cave/explored)
"Gw" = (
/obj/item/stack/ore/salvage/scrapmetal,
/obj/effect/turf_decal/weather/snow,
/obj/effect/turf_decal/weather/snow/surround,
/turf/open/floor/plating/snowed/smoothed/icemoon,
/area/overmap_encounter/planetoid/cave/explored)
"Ht" = (
/obj/structure/destructible/tribal_torch/lit,
/turf/open/floor/plating/asteroid/snow/under,
/area/overmap_encounter/planetoid/cave/explored)
"HO" = (
/obj/structure/table/wood/fancy/purple,
/obj/item/reagent_containers/food/snacks/salad/aesirsalad,
/obj/item/kitchen/fork,
/turf/open/floor/wood/walnut,
/area/overmap_encounter/planetoid/cave/explored)
"In" = (
/obj/structure/bed/double,
/obj/item/bedsheet/double/brown,
/obj/effect/decal/cleanable/cobweb/cobweb2,
/turf/open/floor/wood/walnut,
/area/overmap_encounter/planetoid/cave/explored)
"It" = (
/obj/effect/decal/cleanable/blood/squirt,
/obj/effect/decal/cleanable/blood/squirt,
/obj/effect/decal/cleanable/blood/squirt,
/turf/closed/mineral/snowmountain/icemoon,
/area/overmap_encounter/planetoid/cave/explored)
"Iw" = (
/turf/closed/mineral/snowmountain/icemoon,
/area/overmap_encounter/planetoid/cave/explored)
"IZ" = (
/obj/machinery/atmospherics/pipe/simple/brown{
	dir = 9
	},
/obj/structure/window/reinforced/tinted/frosted{
	dir = 8
	},
/mob/living/simple_animal/hostile/asteroid/ice_demon,
/obj/effect/decal/cleanable/blood/old,
/turf/open/floor/wood/walnut,
/area/overmap_encounter/planetoid/cave/explored)
"Js" = (
/obj/item/shard,
/turf/open/floor/plating/asteroid/snow/under,
/area/overmap_encounter/planetoid/cave/explored)
"Kb" = (
/obj/effect/decal/cleanable/blood/splatter/over_window,
/turf/open/floor/plating/asteroid/snow/under,
/area/overmap_encounter/planetoid/cave/explored)
"Kg" = (
/obj/structure/railing/wood{
	dir = 5
	},
/turf/open/floor/plating/asteroid/snow/under,
/area/overmap_encounter/planetoid/cave/explored)
"Ks" = (
/obj/structure/closet/toolcloset,
/obj/effect/decal/cleanable/blood/old,
/turf/open/floor/wood/walnut,
/area/overmap_encounter/planetoid/cave/explored)
"Kt" = (
/obj/item/shard,
/obj/effect/decal/cleanable/glass,
/obj/effect/decal/cleanable/glass{
	pixel_x = 11;
	pixel_y = 9
	},
/turf/open/floor/plating/asteroid/snow/icemoon,
/area/overmap_encounter/planetoid/cave/explored)
"KT" = (
/mob/living/simple_animal/hostile/asteroid/old_demon{
	name = "Baron Von Shnitz"
	},
/obj/structure/chair/wood/wings,
/turf/open/floor/wood/walnut,
/area/overmap_encounter/planetoid/cave/explored)
"LA" = (
/obj/structure/railing/wood{
	dir = 4
	},
/turf/open/floor/plating/asteroid/snow/icemoon,
/area/overmap_encounter/planetoid/cave/explored)
"LN" = (
/obj/item/stack/ore/salvage/scrapmetal,
/turf/open/floor/plating/asteroid/snow/under,
/area/overmap_encounter/planetoid/cave/explored)
"Mx" = (
/mob/living/simple_animal/hostile/asteroid/ice_demon,
/turf/open/floor/plating/asteroid/snow/under,
/area/overmap_encounter/planetoid/cave/explored)
"ME" = (
/obj/machinery/door/airlock/wood,
/obj/effect/mapping_helpers/airlock/abandoned,
/turf/open/floor/wood/walnut,
/area/overmap_encounter/planetoid/cave/explored)
"Nx" = (
/mob/living/simple_animal/hostile/asteroid/ice_demon,
/turf/open/floor/wood/walnut,
/area/overmap_encounter/planetoid/cave/explored)
"NM" = (
/obj/effect/decal/cleanable/dirt/dust,
/turf/closed/mineral/snowmountain/icemoon,
/area/overmap_encounter/planetoid/cave/explored)
"NS" = (
/obj/item/shard,
/turf/open/floor/wood/walnut,
/area/overmap_encounter/planetoid/cave/explored)
"OR" = (
/obj/machinery/portable_atmospherics/canister/toxins,
/obj/machinery/atmospherics/components/unary/portables_connector{
	dir = 4
	},
/turf/open/floor/wood/walnut,
/area/overmap_encounter/planetoid/cave/explored)
"Py" = (
/obj/effect/decal/cleanable/blood/gibs/body,
/turf/open/floor/plating/asteroid/snow/icemoon,
/area/overmap_encounter/planetoid/cave/explored)
"PI" = (
/obj/item/trash/sosjerky,
/obj/item/trash/sosjerky,
/turf/closed/mineral/snowmountain/icemoon,
/area/overmap_encounter/planetoid/cave/explored)
"QJ" = (
/obj/effect/decal/cleanable/glass,
/obj/effect/decal/cleanable/glass,
/obj/effect/decal/cleanable/glass{
	pixel_x = 11;
	pixel_y = 9
	},
/turf/open/floor/plating/asteroid/snow/under,
/area/overmap_encounter/planetoid/cave/explored)
"RT" = (
/obj/effect/decal/cleanable/blood/tracks{
	dir = 6
	},
/turf/open/floor/plating/asteroid/snow/under,
/area/overmap_encounter/planetoid/cave/explored)
"Ss" = (
/obj/item/stack/ore/salvage/scrapmetal,
/turf/closed/mineral/snowmountain/icemoon,
/area/overmap_encounter/planetoid/cave/explored)
"St" = (
/obj/effect/decal/cleanable/dirt/dust,
/turf/open/floor/plating/asteroid/snow/under,
/area/overmap_encounter/planetoid/cave/explored)
"Th" = (
/obj/effect/decal/remains/human,
/obj/effect/decal/cleanable/dirt/dust,
/obj/effect/decal/cleanable/blood/old,
/obj/item/gem/bloodstone,
/turf/open/floor/wood/walnut,
/area/overmap_encounter/planetoid/cave/explored)
"Ux" = (
/obj/structure/window/plasma/reinforced/plastitanium,
/turf/open/floor/wood/walnut,
/area/overmap_encounter/planetoid/cave/explored)
"Ve" = (
/obj/structure/sign/poster/solgov/terra,
/turf/closed/wall/mineral/iron,
/area/overmap_encounter/planetoid/cave/explored)
"Vv" = (
/obj/effect/decal/cleanable/ash,
/turf/open/floor/plating/asteroid/snow/icemoon,
/area/overmap_encounter/planetoid/cave/explored)
"VY" = (
/obj/item/stack/ore/salvage/scrapmetal,
/obj/structure/railing/wood{
	dir = 1
	},
/turf/open/floor/plating/asteroid/snow/under,
/area/overmap_encounter/planetoid/cave/explored)
"Xq" = (
/obj/machinery/atmospherics/pipe/manifold/brown/visible{
	dir = 4
	},
/turf/open/floor/wood/walnut,
/area/overmap_encounter/planetoid/cave/explored)
"Xt" = (
/obj/structure/bed,
/obj/effect/gibspawner/human/bodypartless,
/turf/open/floor/wood/cold,
/area/overmap_encounter/planetoid/cave/explored)
"Ym" = (
/obj/structure/destructible/tribal_torch/lit,
/turf/open/floor/plating/asteroid/snow/icemoon,
/area/overmap_encounter/planetoid/cave/explored)
"Yp" = (
/obj/machinery/atmospherics/pipe/simple/brown{
	dir = 10
	},
/obj/structure/window/reinforced/tinted/frosted{
	dir = 8
	},
/turf/open/floor/wood/walnut,
/area/overmap_encounter/planetoid/cave/explored)
"YP" = (
/obj/item/trash/can/food,
/turf/open/floor/plating/asteroid/snow/icemoon,
/area/overmap_encounter/planetoid/cave/explored)
"YV" = (
/obj/effect/decal/cleanable/ash,
/turf/open/floor/plating/asteroid/snow/under,
/area/overmap_encounter/planetoid/cave/explored)
"Zd" = (
/obj/structure/table/wood,
/obj/item/trash/candle,
/obj/item/trash/can/food/beans,
/obj/item/gun/ballistic/rifle/illestren,
/obj/item/melee/knife/bone,
/turf/open/floor/wood/cold,
/area/overmap_encounter/planetoid/cave/explored)
"Zm" = (
/obj/item/reagent_containers/food/snacks/meat/slab/human/mutant/skeleton,
/obj/item/trash/raisins,
/obj/item/trash/can/food,
/turf/open/floor/plating/asteroid/snow/icemoon,
/area/overmap_encounter/planetoid/cave/explored)
"Zv" = (
/obj/structure/closet/crate/grave,
/turf/open/floor/plating/asteroid/snow/icemoon,
/area/overmap_encounter/planetoid/cave/explored)

(1,1,1) = {"
FO
FO
FO
FO
FO
FO
FO
FO
FO
FO
FO
FO
FO
FO
FO
ln
ln
ln
ln
ln
ln
ln
Ai
ln
Ai
Ai
LN
ln
FO
FO
"}
(2,1,1) = {"
FO
FO
FO
FO
FO
FO
FO
FO
FO
FO
FO
FO
ln
ln
ln
ln
ln
LN
ln
Ai
ln
Ai
Ai
Ai
Ai
Ai
ln
ln
FO
FO
"}
(3,1,1) = {"
FO
FO
FO
FO
FO
FO
FO
FO
FO
FO
FO
FO
ln
ln
ln
Iw
Ai
Ai
Ai
Ai
Ai
Ai
Ai
Ai
LN
Ai
yY
yY
ln
FO
"}
(4,1,1) = {"
FO
FO
FO
FO
FO
FO
FO
FO
FO
FO
FO
FO
ln
ln
ln
Iw
Ai
Ai
Ai
Ai
Mx
Ai
Ai
Ai
LN
yY
yY
yY
yY
FO
"}
(5,1,1) = {"
FO
FO
ln
FO
FO
yY
yY
FO
yY
ln
ln
ln
ln
ln
yY
LN
Ai
LN
Ai
Ai
Ai
Ai
Ai
Ai
yY
yY
yY
yY
yY
ln
"}
(6,1,1) = {"
FO
FO
ln
yY
yY
yY
gV
yY
yY
yY
ln
ln
yY
yY
ji
LN
LN
Ai
Ai
Ai
Ai
Ai
Ai
LN
yY
yY
yY
yY
yY
ln
"}
(7,1,1) = {"
FO
ln
yY
yY
yY
yY
yY
yY
yY
yY
ln
ln
ln
yY
LN
LN
Ai
Ai
Ai
Ai
Ai
Ai
Ai
ln
yY
yY
yY
yY
yY
yY
"}
(8,1,1) = {"
FO
ln
yY
yY
yY
yY
yY
yY
yY
yY
ln
ln
yY
LN
Ai
Ht
Ai
Ai
Ai
Ai
Ai
Ai
ln
ln
ln
yY
yY
yY
yY
yY
"}
(9,1,1) = {"
FO
ln
ln
ln
Ym
ln
LN
Ai
yY
yY
ln
ln
Ai
ln
ln
Ai
ln
Ai
Ai
Ai
Ai
Ai
ln
ln
dI
ln
ln
ln
yY
yY
"}
(10,1,1) = {"
ln
ln
ln
Iw
ln
ln
ln
Ai
Ai
Ai
Ai
Ai
YV
Ai
Ai
Ai
ln
Ai
Ai
Ai
ln
ln
ln
ln
ln
ln
ln
ln
ln
ln
"}
(11,1,1) = {"
ln
ln
yY
ln
ln
ln
ln
Vv
ln
ln
ln
Ai
Ai
Ai
Ai
Ai
Ai
Ai
Ai
ln
ln
Ai
ln
ln
ln
ln
ln
FO
FO
FO
"}
(12,1,1) = {"
ln
yY
yY
ln
ln
ln
Iw
LN
Ai
Ai
Ai
Ai
Ai
Ai
ln
Ai
Ai
Ai
Ai
Ai
ln
ln
LN
ln
ln
ln
ln
ln
FO
FO
"}
(13,1,1) = {"
ln
yY
Ai
ln
ln
Ai
LN
co
ln
ln
co
Ai
Ai
Ai
Ai
Ai
Ai
Ai
Ai
ln
Ai
ln
ln
ln
dI
yY
ln
ln
FO
FO
"}
(14,1,1) = {"
ln
yY
Ai
ln
Vv
co
Bk
co
ln
ln
co
Ai
co
Ai
Ai
ln
Ai
Ai
Ai
ln
ln
ln
Ai
Iw
yY
yY
FK
ln
ln
ln
"}
(15,1,1) = {"
yY
yY
St
St
cm
co
Ek
co
co
Ek
Ek
Ek
co
Ai
Ai
Ai
Ai
Ai
ln
ln
ln
ln
Ai
Iw
yY
yY
Iw
wH
YP
ly
"}
(16,1,1) = {"
yY
yY
Ai
St
cm
co
aL
Ek
OR
OR
co
aL
co
Ai
ln
dQ
Ai
Ai
ln
ln
LN
ln
Ai
Ai
yY
yY
Iw
zk
Dx
Dg
"}
(17,1,1) = {"
LN
yY
St
cm
rX
Ek
Yp
xc
Xq
Xq
ia
IZ
co
ln
Ai
Ai
Ao
Ai
ln
Iw
Ai
ln
Iw
Ai
yY
YP
Iw
aj
aj
Zm
"}
(18,1,1) = {"
LN
Ai
Ai
cm
cm
Ve
cg
Ks
aj
aj
wk
nr
co
St
Kb
bw
ln
hQ
Ao
Iw
Py
It
nV
ln
Fc
ln
aj
Az
Xt
aj
"}
(19,1,1) = {"
Ai
ln
ln
St
NM
co
Nx
aj
ov
DR
aj
nr
co
Ai
vp
ln
ln
Ai
Iw
yY
Ai
An
xy
Ai
hQ
Iw
iM
wa
Zd
aj
"}
(20,1,1) = {"
Ai
Ai
Ai
NM
Ai
pa
nr
kO
Th
KT
ME
cg
pa
kx
RT
ln
ln
Ai
yY
yY
LN
Iw
ln
ln
VY
ln
aj
aj
aj
PI
"}
(21,1,1) = {"
ln
ln
ln
Vv
ln
pa
nr
aj
In
HO
aj
nr
pa
Ai
ln
ln
Ai
Iw
yY
yY
Iw
Iw
ln
ln
Kg
Iw
LA
LA
Iw
FO
"}
(22,1,1) = {"
Ai
Ai
Ai
Ai
ln
co
fX
aj
aj
aj
aj
fX
co
ln
Ai
ln
Ai
Iw
yY
yY
Iw
LN
ln
ln
Iw
ln
ln
Iw
ln
FO
"}
(23,1,1) = {"
Ai
Ht
ln
Ai
ln
co
Gn
NS
AK
zg
iR
nr
co
ln
Ai
Ai
Ai
Ai
yY
yY
Iw
Ai
ln
ln
Iw
Ai
ln
ln
ln
ln
"}
(24,1,1) = {"
LN
Ai
Ai
Ai
ln
co
uI
Ux
CT
rA
Ux
Ux
Ek
ln
YV
ln
ln
LN
yY
Iw
Iw
LN
Iw
Ss
ln
Ss
LN
yY
FO
FO
"}
(25,1,1) = {"
dI
yY
Ai
Ai
dQ
co
Kt
Ux
Ux
hl
Ux
Iw
Ek
Ai
Iw
Bk
ln
Ym
ln
Iw
Iw
ln
Iw
yY
yY
ln
yY
yY
yY
FO
"}
(26,1,1) = {"
yY
yY
yY
Ai
aE
Gw
QJ
Ai
ln
nP
Js
Ai
co
Ai
Iw
ln
ln
ln
Iw
Iw
Iw
Iw
ln
yY
yY
Zv
yY
yY
yY
yY
"}
(27,1,1) = {"
Ai
Iw
Ai
Ai
ln
Ai
Iw
ln
Js
Ai
Js
ln
Ai
Ai
ln
ln
ln
ln
Iw
Iw
Iw
ln
ln
Iw
yY
yY
yY
yY
yY
yY
"}
(28,1,1) = {"
LN
Ai
ln
Ht
Ai
Ai
ln
Ai
Ai
Ai
Ai
ln
Ai
ln
yY
ln
ln
ln
ln
yY
ln
ln
ln
ln
ln
yY
yY
yY
ln
FO
"}
(29,1,1) = {"
FO
FO
FO
xL
Bl
Iw
Ai
Ai
Ht
Ai
Iw
Ai
yY
yY
yY
yY
ln
ln
yY
ln
ln
ln
Iw
ln
Iw
Iw
ln
ln
ln
FO
"}
(30,1,1) = {"
FO
FO
FO
FO
FO
Ai
LN
Ai
Ai
Iw
Iw
LN
yY
yY
yY
yY
FO
FO
FO
FO
FO
FO
FO
FO
FO
FO
FO
FO
FO
FO
"}
