//MAP CONVERTED BY dmm2tgm.py THIS HEADER COMMENT PREVENTS RECONVERSION, DO NOT REMOVE
"ao" = (
/obj/structure/table_frame/wood,
/turf/open/floor/plating/asteroid/basalt/lava_land_surface,
/area/ruin/unpowered/corprejectrooms{
	name = "Pinnace Wreckage"
	})
"aJ" = (
/obj/effect/turf_decal/industrial/warning,
/obj/effect/decal/cleanable/dirt/dust,
/obj/machinery/atmospherics/components/unary/outlet_injector/layer4,
/turf/open/floor/plating/rust,
/area/ruin/unpowered/corprejectrooms{
	name = "Pinnace Wreckage"
	})
"bN" = (
/obj/structure/table,
/obj/machinery/atmospherics/components/unary/vent_scrubber/layer4,
/obj/item/storage/toolbox/mechanical,
/obj/structure/railing,
/turf/open/floor/plasteel/tech/grid,
/area/ruin/unpowered/corprejectrooms{
	name = "Pinnace Wreckage"
	})
"bS" = (
/obj/structure/girder/displaced,
/turf/open/floor/plating,
/area/ruin/unpowered/corprejectrooms{
	name = "Pinnace Wreckage"
	})
"cb" = (
/obj/machinery/atmospherics/pipe/simple/supply/hidden/layer2{
	dir = 8
	},
/obj/machinery/atmospherics/pipe/simple/scrubbers/hidden/layer4{
	dir = 4
	},
/obj/item/stack/cable_coil/cut/red,
/turf/open/floor/plating,
/area/ruin/unpowered/corprejectrooms{
	name = "Pinnace Wreckage"
	})
"cg" = (
/obj/effect/decal/cleanable/ash/large,
/turf/open/floor/plating/asteroid/basalt/lava_land_surface,
/area/overmap_encounter/planetoid/lava/explored)
"fj" = (
/obj/structure/flora/rock,
/turf/open/floor/plating/asteroid/basalt/lava_land_surface,
/area/overmap_encounter/planetoid/lava/explored)
"fn" = (
/obj/item/stack/cable_coil/cut/red,
/turf/open/floor/plating/asteroid/basalt/lava_land_surface,
/area/ruin/unpowered/corprejectrooms{
	name = "Pinnace Wreckage"
	})
"gg" = (
/obj/machinery/power/shuttle/engine/electric/premium{
	dir = 4;
	desc = "An expensive variant of a standard ion thruster, using highest quality components in order to achieve much better performance. This one seems broken beyond restoration"
	},
/obj/structure/cable{
	icon_state = "0-4"
	},
/turf/open/floor/plating,
/area/ruin/unpowered/corprejectrooms{
	name = "Pinnace Wreckage"
	})
"gk" = (
/obj/structure/rack,
/obj/effect/decal/cleanable/dirt/dust,
/obj/machinery/light/directional/west,
/obj/structure/windoor_assembly{
	dir = 2
	},
/obj/effect/spawner/lootdrop/maintenance/two,
/turf/open/floor/plating/rust,
/area/ruin/unpowered/corprejectrooms{
	name = "Pinnace Wreckage"
	})
"gD" = (
/obj/structure/lattice,
/obj/item/stack/ore/salvage/scraptitanium/five,
/turf/open/floor/plating/asteroid/basalt/lava_land_surface,
/area/ruin/unpowered/corprejectrooms{
	name = "Pinnace Wreckage"
	})
"hx" = (
/obj/machinery/power/smes/shuttle/precharged{
	dir = 8
	},
/obj/structure/window/reinforced{
	dir = 8
	},
/obj/structure/cable{
	icon_state = "0-8"
	},
/turf/open/floor/plasteel/tech/grid,
/area/ruin/unpowered/corprejectrooms{
	name = "Pinnace Wreckage"
	})
"hN" = (
/obj/structure/chair/office{
	dir = 4
	},
/obj/machinery/atmospherics/pipe/simple/scrubbers/hidden/layer4{
	dir = 9
	},
/obj/effect/decal/cleanable/dirt/dust,
/obj/effect/decal/cleanable/blood/gibs/limb,
/obj/effect/decal/cleanable/blood/gibs/limb,
/obj/effect/decal/cleanable/blood/old,
/turf/open/floor/plasteel/mono/white,
/area/ruin/unpowered/corprejectrooms{
	name = "Pinnace Wreckage"
	})
"iZ" = (
/turf/closed/mineral,
/area/ruin/unpowered/corprejectrooms{
	name = "Pinnace Wreckage"
	})
"jS" = (
/obj/effect/decal/cleanable/dirt/dust,
/turf/open/floor/plasteel/dark,
/area/ruin/unpowered/corprejectrooms{
	name = "Pinnace Wreckage"
	})
"kW" = (
/obj/structure/chair/office{
	dir = 1;
	name = "thinking chair";
	desc = "You sit in this. Innovation flows from there."
	},
/obj/effect/decal/cleanable/dirt/dust,
/turf/open/floor/plating,
/area/ruin/unpowered/corprejectrooms{
	name = "Pinnace Wreckage"
	})
"ln" = (
/obj/structure/lattice,
/obj/item/stack/sheet/mineral/wood,
/turf/open/floor/plating/asteroid/basalt/lava_land_surface,
/area/ruin/unpowered/corprejectrooms{
	name = "Pinnace Wreckage"
	})
"lI" = (
/obj/machinery/atmospherics/pipe/simple/supply/hidden/layer2{
	dir = 8
	},
/obj/machinery/atmospherics/pipe/simple/scrubbers/hidden/layer4{
	dir = 4
	},
/obj/effect/decal/cleanable/robot_debris,
/obj/item/broken_bottle,
/obj/item/stack/cable_coil/cut/red,
/turf/open/floor/plating,
/area/ruin/unpowered/corprejectrooms{
	name = "Pinnace Wreckage"
	})
"ni" = (
/turf/open/floor/plating/asteroid/basalt/lava_land_surface,
/area/ruin/unpowered/corprejectrooms{
	name = "Pinnace Wreckage"
	})
"nO" = (
/obj/effect/decal/cleanable/dirt/dust,
/turf/open/floor/plasteel,
/area/ruin/unpowered/corprejectrooms{
	name = "Pinnace Wreckage"
	})
"oT" = (
/obj/machinery/airalarm/directional/south,
/obj/effect/turf_decal/corner_techfloor_grid,
/obj/effect/turf_decal/corner_techfloor_grid{
	dir = 8
	},
/obj/effect/turf_decal/industrial/warning/corner{
	dir = 4
	},
/obj/effect/decal/cleanable/greenglow,
/turf/open/floor/plasteel/tech/techmaint,
/area/ruin/unpowered/corprejectrooms{
	name = "Pinnace Wreckage"
	})
"pA" = (
/obj/effect/spawner/lootdrop/maintenance/two,
/turf/open/floor/plating/asteroid/basalt/lava_land_surface,
/area/overmap_encounter/planetoid/lava/explored)
"rr" = (
/turf/closed/wall/mineral/titanium/nodiagonal,
/area/ruin/unpowered/corprejectrooms{
	name = "Pinnace Wreckage"
	})
"rt" = (
/obj/structure/cable{
	icon_state = "0-5"
	},
/obj/machinery/power/terminal{
	dir = 8
	},
/obj/effect/turf_decal/corner_techfloor_grid/full{
	dir = 1
	},
/turf/open/floor/plating,
/area/ruin/unpowered/corprejectrooms{
	name = "Pinnace Wreckage"
	})
"rV" = (
/obj/structure/rack,
/obj/effect/decal/cleanable/dirt/dust,
/obj/structure/windoor_assembly,
/obj/item/flashlight/glowstick,
/turf/open/floor/plating/rust,
/area/ruin/unpowered/corprejectrooms{
	name = "Pinnace Wreckage"
	})
"uo" = (
/obj/item/clothing/under/shorts/purple,
/turf/open/floor/plating/asteroid/basalt/lava_land_surface,
/area/overmap_encounter/planetoid/lava/explored)
"uA" = (
/obj/effect/turf_decal/industrial/warning/corner{
	dir = 8
	},
/turf/open/floor/plating/rust,
/area/ruin/unpowered/corprejectrooms{
	name = "Pinnace Wreckage"
	})
"uV" = (
/obj/machinery/atmospherics/pipe/simple/supply/hidden/layer2{
	dir = 5
	},
/obj/effect/turf_decal/corner_techfloor_grid{
	dir = 9
	},
/obj/item/light/tube/broken,
/obj/structure/light_construct/directional/west,
/obj/effect/decal/cleanable/dirt/dust,
/turf/open/floor/plasteel/tech/techmaint,
/area/ruin/unpowered/corprejectrooms{
	name = "Pinnace Wreckage"
	})
"vv" = (
/obj/effect/decal/cleanable/ash/large,
/turf/open/floor/plating/asteroid/basalt/lava_land_surface,
/area/ruin/unpowered/corprejectrooms{
	name = "Pinnace Wreckage"
	})
"vH" = (
/obj/structure/rack,
/obj/effect/decal/cleanable/dirt/dust,
/obj/machinery/light/broken/directional/west,
/obj/structure/windoor_assembly,
/turf/open/floor/plating/rust,
/area/ruin/unpowered/corprejectrooms{
	name = "Pinnace Wreckage"
	})
"wq" = (
/turf/closed/indestructible/rock,
/area/overmap_encounter/planetoid/cave/explored)
"xe" = (
/obj/structure/lattice,
/turf/open/floor/plating/asteroid/basalt/lava_land_surface,
/area/ruin/unpowered/corprejectrooms{
	name = "Pinnace Wreckage"
	})
"xf" = (
/obj/structure/cable,
/obj/machinery/holopad/emergency/science,
/obj/machinery/atmospherics/pipe/simple/supply/hidden/layer2{
	dir = 5
	},
/obj/effect/decal/cleanable/dirt/dust,
/obj/item/shard,
/obj/machinery/power/apc/auto_name/directional/south{
	start_charge = 0
	},
/turf/open/floor/plasteel/mono/dark,
/area/ruin/unpowered/corprejectrooms{
	name = "Pinnace Wreckage"
	})
"xo" = (
/obj/structure/frame/computer{
	dir = 8
	},
/obj/effect/turf_decal/industrial/outline/yellow,
/obj/item/stack/cable_coil/cut/red,
/turf/open/floor/plasteel/tech/grid,
/area/ruin/unpowered/corprejectrooms{
	name = "Pinnace Wreckage"
	})
"xI" = (
/obj/structure/cable{
	icon_state = "4-8"
	},
/obj/effect/turf_decal/industrial/warning/corner{
	dir = 1
	},
/obj/machinery/atmospherics/pipe/simple/supply/hidden/layer2{
	dir = 8
	},
/obj/machinery/atmospherics/pipe/simple/scrubbers/hidden/layer4{
	dir = 4
	},
/obj/structure/windoor_assembly{
	dir = 4
	},
/obj/item/stack/tile/plasteel,
/obj/effect/decal/cleanable/blood/tracks{
	dir = 4
	},
/turf/open/floor/plating,
/area/ruin/unpowered/corprejectrooms{
	name = "Pinnace Wreckage"
	})
"xJ" = (
/obj/effect/decal/cleanable/dirt/dust,
/obj/structure/girder,
/obj/item/stack/ore/salvage/scraptitanium,
/turf/open/floor/plating,
/area/ruin/unpowered/corprejectrooms{
	name = "Pinnace Wreckage"
	})
"yD" = (
/obj/item/chair/plastic,
/turf/open/floor/plating/asteroid/basalt/lava_land_surface,
/area/ruin/unpowered/corprejectrooms{
	name = "Pinnace Wreckage"
	})
"yG" = (
/obj/structure/cable{
	icon_state = "4-8"
	},
/obj/effect/turf_decal/industrial/warning{
	dir = 1
	},
/obj/machinery/atmospherics/pipe/manifold/scrubbers/visible/layer4,
/obj/machinery/atmospherics/pipe/manifold/supply/hidden/layer2,
/obj/effect/decal/remains/human,
/obj/effect/decal/cleanable/blood/splatter,
/turf/open/floor/plasteel,
/area/ruin/unpowered/corprejectrooms{
	name = "Pinnace Wreckage"
	})
"yT" = (
/obj/structure/flora/rock/pile,
/turf/open/floor/plating/asteroid/basalt/lava_land_surface,
/area/overmap_encounter/planetoid/lava/explored)
"zb" = (
/obj/structure/lattice,
/obj/structure/flora/rock/pile,
/turf/open/floor/plating/asteroid/basalt/lava_land_surface,
/area/ruin/unpowered/corprejectrooms{
	name = "Pinnace Wreckage"
	})
"zY" = (
/obj/effect/decal/cleanable/dirt/dust,
/turf/open/floor/plasteel/mono/dark,
/area/ruin/unpowered/corprejectrooms{
	name = "Pinnace Wreckage"
	})
"Ag" = (
/obj/structure/girder,
/turf/open/floor/plating/asteroid/basalt/lava_land_surface,
/area/ruin/unpowered/corprejectrooms{
	name = "Pinnace Wreckage"
	})
"Aq" = (
/obj/structure/chair/stool{
	dir = 4
	},
/obj/structure/window{
	dir = 8
	},
/obj/effect/decal/cleanable/dirt/dust,
/turf/open/floor/plasteel/dark,
/area/ruin/unpowered/corprejectrooms{
	name = "Pinnace Wreckage"
	})
"AB" = (
/obj/structure/girder,
/obj/structure/lattice,
/turf/open/floor/plating/asteroid/basalt/lava_land_surface,
/area/ruin/unpowered/corprejectrooms{
	name = "Pinnace Wreckage"
	})
"AN" = (
/obj/structure/cable{
	icon_state = "2-8"
	},
/obj/machinery/atmospherics/pipe/simple/supply/hidden/layer2{
	dir = 10
	},
/obj/machinery/atmospherics/pipe/simple/scrubbers/hidden/layer4{
	dir = 4
	},
/obj/item/stack/tile/plasteel,
/obj/effect/decal/cleanable/blood/tracks{
	dir = 4
	},
/turf/open/floor/plating,
/area/ruin/unpowered/corprejectrooms{
	name = "Pinnace Wreckage"
	})
"AU" = (
/obj/item/stack/ore/salvage/scraptitanium,
/turf/open/floor/plating/asteroid/basalt/lava_land_surface,
/area/overmap_encounter/planetoid/lava/explored)
"Cm" = (
/obj/effect/decal/cleanable/robot_debris,
/obj/item/stack/tile/plasteel/dark,
/turf/open/floor/plating,
/area/ruin/unpowered/corprejectrooms{
	name = "Pinnace Wreckage"
	})
"CY" = (
/obj/structure/cable{
	icon_state = "2-4"
	},
/obj/structure/cable{
	icon_state = "4-8"
	},
/obj/effect/turf_decal/corner_techfloor_grid{
	dir = 1
	},
/obj/effect/turf_decal/corner_techfloor_grid{
	dir = 4
	},
/obj/effect/decal/cleanable/plasma,
/turf/open/floor/plasteel/tech/techmaint,
/area/ruin/unpowered/corprejectrooms{
	name = "Pinnace Wreckage"
	})
"DP" = (
/obj/structure/grille/broken,
/obj/item/shard,
/turf/open/floor/plating,
/area/ruin/unpowered/corprejectrooms{
	name = "Pinnace Wreckage"
	})
"Fv" = (
/obj/effect/spawner/lootdrop/maintenance/two,
/turf/open/floor/plating/asteroid/basalt/lava_land_surface,
/area/ruin/unpowered/corprejectrooms{
	name = "Pinnace Wreckage"
	})
"FD" = (
/obj/effect/turf_decal/industrial/warning/corner,
/turf/open/floor/plating/rust,
/area/ruin/unpowered/corprejectrooms{
	name = "Pinnace Wreckage"
	})
"Gn" = (
/obj/machinery/atmospherics/pipe/layer_manifold,
/obj/effect/mapping_helpers/airlock/locked,
/obj/machinery/door/airlock/shuttle,
/turf/open/floor/plasteel/mono/white,
/area/ruin/unpowered/corprejectrooms{
	name = "Pinnace Wreckage"
	})
"Gt" = (
/obj/structure/closet/wall/white/directional/east{
	name = "survey gear"
	},
/obj/item/survey_handheld/elite,
/obj/item/survey_handheld/advanced,
/obj/item/survey_handheld/advanced,
/obj/item/clothing/accessory/armband/science,
/obj/item/clothing/suit/toggle/labcoat/science,
/obj/item/clothing/glasses/science,
/obj/item/tank/internals/oxygen,
/obj/effect/decal/cleanable/dirt/dust,
/turf/open/floor/plating,
/area/ruin/unpowered/corprejectrooms{
	name = "Pinnace Wreckage"
	})
"Gw" = (
/obj/machinery/atmospherics/components/unary/portables_connector/visible/layer2,
/obj/effect/turf_decal/corner_techfloor_grid{
	dir = 9
	},
/turf/open/floor/plasteel/tech/techmaint,
/area/ruin/unpowered/corprejectrooms{
	name = "Pinnace Wreckage"
	})
"HM" = (
/obj/structure/cable{
	icon_state = "1-2"
	},
/obj/effect/decal/cleanable/ash,
/obj/effect/turf_decal/industrial/warning/corner,
/obj/effect/decal/cleanable/dirt/dust,
/obj/item/stack/ore/salvage/scrapplasma,
/turf/open/floor/plasteel/tech/techmaint,
/area/ruin/unpowered/corprejectrooms{
	name = "Pinnace Wreckage"
	})
"HT" = (
/obj/item/stack/ore/salvage/scraptitanium/five,
/turf/open/floor/plating/asteroid/basalt/lava_land_surface,
/area/overmap_encounter/planetoid/lava/explored)
"Ik" = (
/obj/structure/lattice,
/obj/structure/fluff/beach_umbrella/science,
/turf/open/floor/plating/asteroid/basalt/lava_land_surface,
/area/ruin/unpowered/corprejectrooms{
	name = "Pinnace Wreckage"
	})
"Is" = (
/obj/structure/bed,
/obj/structure/curtain,
/obj/item/shard,
/turf/open/floor/plasteel/mono/dark,
/area/ruin/unpowered/corprejectrooms{
	name = "Pinnace Wreckage"
	})
"Iv" = (
/obj/machinery/atmospherics/components/unary/vent_pump/layer2{
	dir = 1
	},
/obj/structure/railing{
	dir = 1
	},
/obj/structure/railing{
	dir = 4
	},
/obj/effect/decal/cleanable/dirt/dust,
/turf/open/floor/plasteel/tech/grid,
/area/ruin/unpowered/corprejectrooms{
	name = "Pinnace Wreckage"
	})
"IC" = (
/obj/machinery/power/shuttle/engine/electric/premium{
	dir = 4;
	desc = "An expensive variant of a standard ion thruster, using highest quality components in order to achieve much better performance. This one seems broken beyond restoration"
	},
/turf/open/floor/plating,
/area/ruin/unpowered/corprejectrooms{
	name = "Pinnace Wreckage"
	})
"Jg" = (
/obj/structure/frame/machine,
/obj/machinery/light/small/broken/directional/west,
/turf/open/floor/plating,
/area/ruin/unpowered/corprejectrooms{
	name = "Pinnace Wreckage"
	})
"JS" = (
/obj/structure/cable{
	icon_state = "0-8"
	},
/obj/effect/turf_decal/industrial/outline/yellow,
/obj/effect/decal/cleanable/cobweb/cobweb2,
/obj/effect/decal/cleanable/plasma,
/turf/open/floor/plasteel/tech/grid,
/area/ruin/unpowered/corprejectrooms{
	name = "Pinnace Wreckage"
	})
"Lz" = (
/obj/machinery/atmospherics/components/unary/vent_pump/layer2{
	dir = 8
	},
/obj/effect/turf_decal/box,
/obj/structure/table_frame,
/turf/open/floor/plasteel/mono/dark,
/area/ruin/unpowered/corprejectrooms{
	name = "Pinnace Wreckage"
	})
"LH" = (
/obj/structure/table{
	name = "thinking table"
	},
/turf/open/floor/plating,
/area/ruin/unpowered/corprejectrooms{
	name = "Pinnace Wreckage"
	})
"Nf" = (
/obj/item/reagent_containers/food/snacks/canned/beans,
/obj/structure/sign/poster/official/science{
	pixel_y = -32
	},
/obj/effect/decal/cleanable/ash/large,
/obj/machinery/light/small/broken/directional/south,
/obj/item/shard,
/obj/structure/table_frame,
/turf/open/floor/plasteel/mono/dark,
/area/ruin/unpowered/corprejectrooms{
	name = "Pinnace Wreckage"
	})
"NB" = (
/obj/structure/flora/rock,
/turf/open/floor/plating/asteroid/basalt/lava_land_surface,
/area/ruin/unpowered/corprejectrooms{
	name = "Pinnace Wreckage"
	})
"NR" = (
/obj/machinery/atmospherics/pipe/simple/scrubbers/hidden/layer4,
/obj/item/shard,
/turf/open/floor/plasteel/mono/white,
/area/ruin/unpowered/corprejectrooms{
	name = "Pinnace Wreckage"
	})
"Oa" = (
/turf/closed/wall/mineral/titanium,
/area/ruin/unpowered/corprejectrooms{
	name = "Pinnace Wreckage"
	})
"Ol" = (
/obj/structure/girder,
/obj/item/stack/ore/salvage/scraptitanium,
/turf/open/floor/plating,
/area/ruin/unpowered/corprejectrooms{
	name = "Pinnace Wreckage"
	})
"Om" = (
/obj/structure/girder/displaced,
/obj/item/stack/ore/salvage/scraptitanium/five,
/turf/open/floor/plating,
/area/ruin/unpowered/corprejectrooms{
	name = "Pinnace Wreckage"
	})
"Oz" = (
/obj/machinery/atmospherics/pipe/simple/supply/hidden/layer2{
	dir = 8
	},
/obj/machinery/atmospherics/pipe/simple/scrubbers/hidden/layer4{
	dir = 4
	},
/obj/item/stack/cable_coil/cut/red,
/turf/open/floor/plating/rust,
/area/ruin/unpowered/corprejectrooms{
	name = "Pinnace Wreckage"
	})
"OL" = (
/obj/machinery/door/window{
	dir = 8
	},
/obj/structure/cable{
	icon_state = "4-8"
	},
/obj/machinery/atmospherics/pipe/simple/supply/hidden/layer2{
	dir = 8
	},
/obj/machinery/atmospherics/pipe/simple/scrubbers/hidden/layer4{
	dir = 4
	},
/obj/effect/turf_decal/industrial/warning{
	dir = 8
	},
/obj/structure/frame/computer{
	dir = 4
	},
/turf/open/floor/plasteel,
/area/ruin/unpowered/corprejectrooms{
	name = "Pinnace Wreckage"
	})
"Po" = (
/obj/structure/chair/stool{
	dir = 8
	},
/obj/item/shard,
/turf/open/floor/plasteel/dark,
/area/ruin/unpowered/corprejectrooms{
	name = "Pinnace Wreckage"
	})
"PJ" = (
/turf/closed/mineral,
/area/overmap_encounter/planetoid/cave/explored)
"Rh" = (
/obj/item/stack/ore/salvage/scraptitanium,
/obj/structure/flora/rock,
/turf/open/floor/plating/asteroid/basalt/lava_land_surface,
/area/overmap_encounter/planetoid/lava/explored)
"Rw" = (
/obj/effect/decal/cleanable/dirt/dust,
/obj/machinery/light/small/broken/directional/east,
/turf/open/floor/plating,
/area/ruin/unpowered/corprejectrooms{
	name = "Pinnace Wreckage"
	})
"SD" = (
/turf/open/floor/plating/asteroid/basalt/lava_land_surface,
/area/overmap_encounter/planetoid/lava/explored)
"Te" = (
/obj/item/clothing/glasses/cheapsuns,
/turf/open/floor/plating/asteroid/basalt/lava_land_surface,
/area/overmap_encounter/planetoid/lava/explored)
"Tf" = (
/obj/structure/frame/computer{
	dir = 8
	},
/obj/effect/turf_decal/industrial/outline/yellow,
/obj/item/shard,
/turf/open/floor/plasteel/tech/grid,
/area/ruin/unpowered/corprejectrooms{
	name = "Pinnace Wreckage"
	})
"Tl" = (
/obj/machinery/atmospherics/pipe/simple/scrubbers/hidden/layer4,
/obj/machinery/atmospherics/pipe/simple/supply/hidden/layer2,
/obj/structure/door_assembly/door_assembly_shuttle,
/turf/open/floor/plasteel/mono/white,
/area/ruin/unpowered/corprejectrooms{
	name = "Pinnace Wreckage"
	})
"UO" = (
/obj/structure/cable{
	icon_state = "0-4"
	},
/obj/machinery/power/terminal{
	dir = 8
	},
/obj/effect/turf_decal/corner_techfloor_grid/full{
	dir = 4
	},
/obj/effect/decal/cleanable/cobweb,
/obj/machinery/power/port_gen/pacman,
/turf/open/floor/plating,
/area/ruin/unpowered/corprejectrooms{
	name = "Pinnace Wreckage"
	})
"Ve" = (
/obj/machinery/atmospherics/components/binary/dp_vent_pump/on/layer2,
/obj/machinery/atmospherics/pipe/simple/scrubbers/hidden/layer4,
/obj/machinery/advanced_airlock_controller{
	pixel_x = 30
	},
/turf/open/floor/plating/rust,
/area/ruin/unpowered/corprejectrooms{
	name = "Pinnace Wreckage"
	})
"Vf" = (
/obj/machinery/atmospherics/components/unary/vent_scrubber/layer4,
/obj/effect/turf_decal/box,
/obj/structure/table_frame,
/turf/open/floor/plasteel/mono/dark,
/area/ruin/unpowered/corprejectrooms{
	name = "Pinnace Wreckage"
	})
"VS" = (
/obj/machinery/airalarm/directional/west,
/obj/effect/decal/cleanable/dirt/dust,
/obj/machinery/light/small/broken/directional/west,
/obj/item/bedsheet/rd,
/turf/open/floor/plating,
/area/ruin/unpowered/corprejectrooms{
	name = "Pinnace Wreckage"
	})
"Wg" = (
/obj/effect/decal/cleanable/dirt/dust,
/obj/item/rack_parts,
/obj/structure/windoor_assembly{
	dir = 2
	},
/obj/effect/decal/cleanable/ash/large,
/turf/open/floor/plating/rust,
/area/ruin/unpowered/corprejectrooms{
	name = "Pinnace Wreckage"
	})
"Wu" = (
/obj/structure/girder,
/turf/open/floor/plating/rust,
/area/ruin/unpowered/corprejectrooms{
	name = "Pinnace Wreckage"
	})
"Wz" = (
/turf/template_noop,
/area/template_noop)
"WL" = (
/obj/effect/turf_decal/industrial/warning{
	dir = 8
	},
/obj/structure/window/reinforced{
	dir = 8
	},
/turf/open/floor/plasteel,
/area/ruin/unpowered/corprejectrooms{
	name = "Pinnace Wreckage"
	})
"Xn" = (
/obj/structure/grille/broken,
/turf/open/floor/plating/rust,
/area/ruin/unpowered/corprejectrooms{
	name = "Pinnace Wreckage"
	})
"Yo" = (
/obj/structure/lattice,
/obj/effect/decal/cleanable/ash/large,
/turf/open/floor/plating/asteroid/basalt/lava_land_surface,
/area/ruin/unpowered/corprejectrooms{
	name = "Pinnace Wreckage"
	})
"Zk" = (
/obj/item/stack/ore/salvage/scraptitanium,
/obj/item/chair/plastic,
/turf/open/floor/plating/asteroid/basalt/lava_land_surface,
/area/overmap_encounter/planetoid/lava/explored)
"Zo" = (
/obj/structure/lattice,
/obj/item/stack/ore/salvage/scraptitanium,
/turf/open/floor/plating/asteroid/basalt/lava_land_surface,
/area/ruin/unpowered/corprejectrooms{
	name = "Pinnace Wreckage"
	})
"Zu" = (
/obj/structure/cable{
	icon_state = "1-4"
	},
/obj/structure/cable{
	icon_state = "1-10"
	},
/obj/machinery/atmospherics/components/binary/pump/layer2{
	dir = 4
	},
/obj/effect/turf_decal/industrial/warning{
	dir = 4
	},
/obj/effect/decal/cleanable/dirt/dust,
/turf/open/floor/plasteel/tech/techmaint,
/area/ruin/unpowered/corprejectrooms{
	name = "Pinnace Wreckage"
	})
"ZJ" = (
/obj/structure/cable{
	icon_state = "4-8"
	},
/obj/machinery/atmospherics/pipe/manifold/supply/hidden/layer2{
	dir = 1
	},
/obj/machinery/atmospherics/pipe/simple/scrubbers/hidden/layer4{
	dir = 5
	},
/turf/open/floor/plasteel/stairs{
	dir = 4
	},
/area/ruin/unpowered/corprejectrooms{
	name = "Pinnace Wreckage"
	})
"ZM" = (
/obj/structure/girder,
/obj/item/stack/ore/salvage/scraptitanium/five,
/turf/open/floor/plating,
/area/ruin/unpowered/corprejectrooms{
	name = "Pinnace Wreckage"
	})
"ZO" = (
/obj/machinery/door/window{
	dir = 8
	},
/obj/structure/cable{
	icon_state = "4-8"
	},
/obj/effect/turf_decal/industrial/warning/corner{
	dir = 4
	},
/obj/machinery/atmospherics/pipe/simple/supply/hidden/layer2{
	dir = 8
	},
/obj/machinery/atmospherics/pipe/simple/scrubbers/hidden/layer4{
	dir = 4
	},
/turf/open/floor/plasteel,
/area/ruin/unpowered/corprejectrooms{
	name = "Pinnace Wreckage"
	})

(1,1,1) = {"
Wz
Wz
Wz
Wz
Wz
Wz
Wz
Wz
Wu
rr
SD
cg
Wz
Wz
Wz
Wz
Wz
Wz
Wz
Wz
SD
SD
SD
SD
SD
SD
Wz
Wz
Wz
Wz
"}
(2,1,1) = {"
Wz
Wz
Wz
Wz
Wz
Wz
Wz
Wz
SD
rr
rr
IC
SD
Wz
Wz
Wz
Wz
Wz
Wz
SD
SD
SD
SD
SD
SD
SD
Wz
Wz
Wz
Wz
"}
(3,1,1) = {"
Wz
Wz
Wz
Wz
Wz
Wz
Wz
Wz
cg
vH
xe
fn
gD
SD
cg
SD
SD
SD
SD
Te
SD
Yo
Oa
bS
xe
SD
Wz
Wz
Wz
Wz
"}
(4,1,1) = {"
Wz
Wz
Wz
Wz
Wz
Wz
Wz
Wz
SD
rV
xe
xe
xe
SD
HT
gg
Oa
SD
NB
ni
ni
Zo
Oa
wq
xe
SD
Wz
Wz
Wz
Wz
"}
(5,1,1) = {"
Wz
Wz
Wz
Wz
Wz
Wz
Wz
Wz
fj
AB
Zo
Oa
hx
Oa
Oa
hx
Oa
xe
ni
yD
ni
ln
gk
SD
SD
SD
SD
Wz
Wz
Wz
"}
(6,1,1) = {"
Wz
Wz
Wz
Wz
Wz
Wz
Wz
Wz
SD
Zo
xe
Oa
UO
Gw
uV
rt
Oa
xe
ni
ao
Fv
xe
Wg
SD
SD
SD
Wz
Wz
Wz
Wz
"}
(7,1,1) = {"
Wz
Wz
Wz
Wz
Wz
Wz
Wz
Wz
SD
yT
xe
Oa
CY
HM
Zu
oT
Oa
xe
Ik
ni
ni
xe
Ag
SD
SD
Wz
Wz
Wz
Wz
Wz
"}
(8,1,1) = {"
Wz
Wz
Wz
Wz
Wz
Wz
Wz
Wz
SD
SD
xe
Oa
JS
bN
ZJ
Iv
Oa
Yo
xe
SD
Zk
SD
Rh
SD
Wz
Wz
Wz
Wz
Wz
Wz
"}
(9,1,1) = {"
Wz
Wz
Wz
Wz
Wz
Wz
Wz
Wz
Wz
SD
xe
Oa
Oa
Oa
OL
WL
Oa
xe
SD
uo
pA
SD
SD
SD
Wz
Wz
Wz
Wz
Wz
Wz
"}
(10,1,1) = {"
Wz
Wz
Wz
Wz
Wz
Wz
Wz
Wz
Wz
SD
cg
Oa
jS
Jg
lI
zY
xJ
SD
SD
yT
SD
AU
SD
Wz
Wz
Wz
Wz
Wz
Wz
Wz
"}
(11,1,1) = {"
Wz
Wz
Wz
Wz
Wz
Wz
Wz
Wz
Wz
fj
SD
DP
LH
kW
Oz
xe
Yo
AU
yT
SD
fj
SD
SD
Wz
Wz
Wz
Wz
Wz
Wz
Wz
"}
(12,1,1) = {"
Wz
Wz
Wz
Wz
Wz
Wz
Wz
Wz
Wz
SD
SD
Yo
xe
xe
xe
Cm
Xn
SD
SD
SD
SD
SD
Wz
Wz
Wz
Wz
Wz
Wz
Wz
Wz
"}
(13,1,1) = {"
Wz
Wz
Wz
Wz
Wz
Wz
Wz
Wz
Wz
Wz
SD
ni
ni
ni
ni
xe
vv
SD
SD
SD
SD
yT
Wz
Wz
Wz
Wz
Wz
Wz
Wz
Wz
"}
(14,1,1) = {"
Wz
Wz
Wz
Wz
Wz
Wz
SD
Wz
Wz
Wz
SD
ni
zb
xe
Yo
xe
xe
xe
xe
SD
SD
SD
Wz
Wz
Wz
Wz
Wz
Wz
Wz
Wz
"}
(15,1,1) = {"
Wz
Wz
SD
SD
SD
SD
SD
SD
SD
SD
SD
SD
SD
Om
Gt
Rw
cb
nO
Oa
SD
SD
SD
Wz
Wz
Wz
SD
SD
SD
Wz
Wz
"}
(16,1,1) = {"
Wz
Wz
SD
PJ
SD
SD
fj
SD
SD
HT
fj
SD
FD
Oa
Oa
Oa
ZO
Aq
Oa
SD
SD
SD
Wz
Wz
fj
SD
PJ
PJ
Wz
Wz
"}
(17,1,1) = {"
Wz
Wz
Wz
PJ
PJ
PJ
SD
SD
SD
HT
SD
SD
aJ
Gn
Ve
Tl
yG
Nf
Oa
SD
SD
SD
SD
SD
SD
SD
PJ
PJ
PJ
Wz
"}
(18,1,1) = {"
Wz
Wz
Wz
PJ
PJ
PJ
PJ
SD
PJ
SD
SD
SD
uA
rr
Oa
Oa
xI
Po
Oa
SD
SD
SD
SD
SD
SD
PJ
PJ
PJ
PJ
Wz
"}
(19,1,1) = {"
Wz
Wz
Wz
Wz
PJ
PJ
PJ
PJ
PJ
PJ
SD
HT
SD
Oa
Is
VS
AN
xf
Oa
SD
fj
SD
yT
PJ
PJ
PJ
PJ
PJ
Wz
Wz
"}
(20,1,1) = {"
Wz
Wz
Wz
Wz
PJ
PJ
PJ
PJ
PJ
PJ
yT
SD
SD
Oa
Vf
NR
hN
Lz
Oa
SD
SD
SD
PJ
PJ
PJ
PJ
PJ
Wz
Wz
Wz
"}
(21,1,1) = {"
Wz
Wz
Wz
Wz
Wz
PJ
PJ
PJ
PJ
PJ
PJ
PJ
yT
ZM
Oa
xo
Tf
Om
Oa
SD
yT
yT
PJ
PJ
PJ
PJ
Wz
Wz
Wz
Wz
"}
(22,1,1) = {"
Wz
Wz
Wz
Wz
Wz
Wz
PJ
PJ
PJ
PJ
PJ
PJ
PJ
bS
Oa
DP
DP
iZ
Ol
PJ
PJ
PJ
PJ
PJ
PJ
PJ
Wz
Wz
Wz
Wz
"}
(23,1,1) = {"
Wz
Wz
Wz
Wz
Wz
Wz
PJ
PJ
PJ
PJ
PJ
PJ
PJ
PJ
PJ
PJ
PJ
PJ
PJ
PJ
PJ
PJ
PJ
PJ
PJ
Wz
Wz
Wz
Wz
Wz
"}
(24,1,1) = {"
Wz
Wz
Wz
Wz
Wz
Wz
Wz
PJ
PJ
PJ
PJ
PJ
PJ
PJ
PJ
PJ
PJ
PJ
PJ
PJ
PJ
PJ
PJ
PJ
PJ
Wz
Wz
Wz
Wz
Wz
"}
(25,1,1) = {"
Wz
Wz
Wz
Wz
Wz
Wz
Wz
Wz
PJ
PJ
PJ
PJ
PJ
PJ
PJ
PJ
PJ
PJ
PJ
PJ
PJ
PJ
PJ
Wz
Wz
Wz
Wz
Wz
Wz
Wz
"}
(26,1,1) = {"
Wz
Wz
Wz
Wz
Wz
Wz
Wz
Wz
Wz
PJ
PJ
PJ
PJ
PJ
PJ
PJ
PJ
PJ
PJ
PJ
PJ
PJ
Wz
Wz
Wz
Wz
Wz
Wz
Wz
Wz
"}
(27,1,1) = {"
Wz
Wz
Wz
Wz
Wz
Wz
Wz
Wz
Wz
Wz
Wz
PJ
PJ
PJ
PJ
PJ
PJ
PJ
PJ
PJ
PJ
Wz
Wz
Wz
Wz
Wz
Wz
Wz
Wz
Wz
"}
(28,1,1) = {"
Wz
Wz
Wz
Wz
Wz
Wz
Wz
Wz
Wz
Wz
Wz
Wz
Wz
PJ
PJ
PJ
PJ
PJ
Wz
Wz
Wz
Wz
Wz
Wz
Wz
Wz
Wz
Wz
Wz
Wz
"}
(29,1,1) = {"
Wz
Wz
Wz
Wz
Wz
Wz
Wz
Wz
Wz
Wz
Wz
Wz
Wz
Wz
Wz
Wz
Wz
Wz
Wz
Wz
Wz
Wz
Wz
Wz
Wz
Wz
Wz
Wz
Wz
Wz
"}
(30,1,1) = {"
Wz
Wz
Wz
Wz
Wz
Wz
Wz
Wz
Wz
Wz
Wz
Wz
Wz
Wz
Wz
Wz
Wz
Wz
Wz
Wz
Wz
Wz
Wz
Wz
Wz
Wz
Wz
Wz
Wz
Wz
"}
